userID,trajID,poiID,startTime,endTime,#photo,trajLen,poiDuration
10297518@N00,1,20,1277722924,1277724432,6,1,1508
10307040@N08,2,6,1382615844,1382615844,1,4,0
10307040@N08,2,8,1382615012,1382615012,1,4,0
10307040@N08,2,21,1382614961,1382614974,2,4,13
10307040@N08,2,22,1382615079,1382615828,9,4,749
10340578@N06,3,21,1364293448,1364294431,8,3,983
10340578@N06,3,22,1364296281,1364296291,2,3,10
10340578@N06,3,3,1364296318,1364296318,1,3,0
10340578@N06,4,8,1364454407,1364455533,10,3,1126
10340578@N06,4,2,1364438916,1364439134,6,3,218
10340578@N06,4,1,1364439296,1364439296,1,3,0
10422365@N03,5,24,1302063964,1302063964,1,1,0
10422365@N03,6,8,1302410413,1302410413,1,1,0
10422365@N03,7,7,1350190975,1350191213,2,1,238
11354044@N05,8,2,1337846692,1337846692,1,4,0
11354044@N05,8,12,1337828401,1337829688,3,4,1287
11354044@N05,8,15,1337823289,1337823289,1,4,0
11354044@N05,8,22,1337812953,1337816001,3,4,3048
11354044@N05,9,23,1337938198,1337938198,1,1,0
115391424@N05,10,12,1394345177,1394346638,9,1,1461
115391424@N05,11,2,1395545820,1395548262,20,2,2442
115391424@N05,11,1,1395546224,1395546984,19,2,760
115391424@N05,12,2,1398557262,1398561313,47,2,4051
115391424@N05,12,1,1398556765,1398559833,12,2,3068
12002368@N08,13,22,1312271626,1312271626,1,1,0
12002368@N08,14,8,1345006932,1345006932,1,1,0
12173213@N00,15,5,1322210239,1322210239,1,1,0
12173213@N00,16,5,1323162323,1323162412,5,1,89
123434952@N02,17,20,1384405560,1384405560,1,2,0
123434952@N02,17,8,1384411482,1384416641,6,2,5159
12384872@N08,18,8,1374801995,1374801995,1,1,0
12452841@N00,19,20,1324904857,1324904903,2,1,46
12452841@N00,20,27,1325030101,1325030101,1,2,0
12452841@N00,20,20,1325024811,1325024885,2,2,74
12452841@N00,21,21,1397810972,1397818056,2,1,7084
12452841@N00,22,21,1397880438,1397906217,12,3,25779
12452841@N00,22,20,1397870041,1397870132,6,3,91
12452841@N00,22,24,1397880139,1397880329,3,3,190
12452841@N00,23,21,1397990484,1397990712,8,5,228
12452841@N00,23,23,1397988216,1397988216,1,5,0
12452841@N00,23,3,1397986899,1397987261,2,5,362
12452841@N00,23,10,1397986381,1397986539,2,5,158
12452841@N00,23,20,1397989105,1397989184,2,5,79
12452841@N00,24,21,1398081594,1398081594,1,1,0
12452841@N00,25,21,1398128003,1398130973,8,2,2970
12452841@N00,25,20,1398132061,1398141365,18,2,9304
12455012@N00,26,20,1311751653,1311751826,2,1,173
12455012@N00,27,6,1312029909,1312031758,3,1,1849
12505664@N00,28,20,1378794137,1378794137,1,1,0
12505664@N00,29,20,1380089934,1380089934,1,1,0
12527903@N00,30,15,1245553321,1245554608,3,2,1287
12527903@N00,30,6,1245563625,1245563625,1,2,0
12767075@N02,31,6,1372820162,1372820162,1,1,0
12810816@N08,32,7,1386392662,1386409187,4,1,16525
13322960@N00,33,8,1290144238,1290156388,29,2,12150
13322960@N00,33,6,1290166473,1290169929,12,2,3456
13322960@N00,34,6,1290218863,1290218977,2,1,114
13715300@N06,35,24,1220838012,1220838012,1,1,0
13715300@N06,36,8,1221024529,1221028507,77,1,3978
13715300@N06,37,4,1221125265,1221134480,28,1,9215
13897419@N02,38,16,1362101160,1362108720,9,1,7560
13991984@N05,39,8,1367382112,1367382112,1,1,0
14003952@N04,40,20,1364946871,1364964870,6,3,17999
14003952@N04,40,6,1364936556,1364962018,31,3,25462
14003952@N04,40,5,1364960626,1364960770,12,3,144
14224905@N08,41,8,1272525324,1272526567,2,1,1243
14224905@N08,42,8,1359967436,1359967436,1,1,0
14674202@N04,43,6,1304154004,1304154004,1,1,0
15702545@N00,44,18,1239457241,1239457241,1,1,0
16501075@N00,45,2,1319340404,1319340486,2,2,82
16501075@N00,45,1,1319340295,1319340295,1,2,0
17155295@N00,46,8,1239067615,1239072827,9,1,5212
17267375@N05,47,20,1345192052,1345192052,1,1,0
17407749@N00,48,1,1099206009,1099206009,1,1,0
17407749@N00,49,22,1112664300,1112664392,3,1,92
17407749@N00,50,22,1112699346,1112699529,3,1,183
17407749@N00,51,5,1136640022,1136640022,1,1,0
17407749@N00,52,8,1144555449,1144559160,4,1,3711
17407749@N00,53,5,1146293397,1146293397,1,1,0
17407749@N00,54,20,1152766064,1152766064,1,1,0
17407749@N00,55,21,1152875209,1152875209,1,1,0
17691489@N06,56,22,1177209077,1177209077,1,1,0
17691489@N06,57,24,1189833260,1189833260,1,1,0
17757546@N00,58,6,1211237800,1211237800,1,1,0
17835110@N00,59,1,1216259416,1216260603,8,1,1187
19544554@N00,60,6,1153022501,1153049818,64,1,27317
20448026@N00,61,20,1265422249,1265422249,1,1,0
21147679@N08,62,20,1380976789,1380976789,1,3,0
21147679@N08,62,22,1380970493,1380970493,1,3,0
21147679@N08,62,23,1380962735,1380963549,2,3,814
21147679@N08,63,28,1381019998,1381019998,1,1,0
21147679@N08,64,22,1383137929,1383137929,1,1,0
21225669@N00,65,6,1154493299,1154497221,7,1,3922
21334807@N00,66,1,1352039956,1352039956,1,1,0
21442750@N07,67,5,1293954444,1293965395,11,1,10951
21442750@N07,68,24,1294118672,1294118790,2,2,118
21442750@N07,68,20,1294126521,1294127069,4,2,548
21550108@N02,69,2,1233065513,1233065513,1,1,0
21772716@N03,70,8,1395983979,1395983979,1,1,0
21872605@N00,71,22,1372322193,1372325044,5,2,2851
21872605@N00,71,3,1372322432,1372322432,1,2,0
21872605@N00,72,20,1372464341,1372464341,1,1,0
21903607@N04,73,5,1313500304,1313500304,1,1,0
21929939@N06,74,20,1345036549,1345036549,1,1,0
22087824@N00,75,17,1239398100,1239398280,3,3,180
22087824@N00,75,8,1239400860,1239402360,5,3,1500
22087824@N00,75,20,1239393871,1239427920,2,3,34049
22326777@N06,76,8,1333954308,1333959365,3,2,5057
22326777@N06,76,1,1333949430,1333949430,1,2,0
22613977@N04,77,1,1234236379,1234236399,6,2,20
22613977@N04,77,2,1234236387,1234236387,1,2,0
22669489@N00,78,20,1307524637,1307524637,1,5,0
22669489@N00,78,22,1307519019,1307520910,7,5,1891
22669489@N00,78,1,1307512530,1307514543,7,5,2013
22669489@N00,78,8,1307507242,1307507401,4,5,159
22669489@N00,78,21,1307526402,1307526725,3,5,323
22765417@N06,79,18,1289707133,1289707167,2,1,34
22765417@N06,80,18,1300495340,1300495340,1,1,0
22765417@N06,81,23,1300603504,1300603504,1,1,0
22765417@N06,82,18,1318136966,1318137464,5,1,498
22765417@N06,83,18,1325212425,1325212619,3,1,194
22765417@N06,84,15,1325650727,1325653449,15,2,2722
22765417@N06,84,3,1325655491,1325655519,2,2,28
22765417@N06,85,3,1327820875,1327820875,1,2,0
22765417@N06,85,22,1327819410,1327820944,19,2,1534
22765417@N06,86,15,1329004141,1329006108,8,1,1967
22765417@N06,87,18,1330834394,1330834402,2,1,8
22765417@N06,88,15,1333242892,1333242892,1,1,0
22765417@N06,89,15,1333887773,1333887773,1,1,0
22765417@N06,90,15,1334064495,1334064495,1,1,0
22765417@N06,91,15,1334975603,1334982206,8,1,6603
22765417@N06,92,15,1338859447,1338859845,2,1,398
22765417@N06,93,8,1345347004,1345347010,2,1,6
22765417@N06,94,15,1347142127,1347145044,8,1,2917
22765417@N06,95,15,1350776928,1350780637,16,1,3709
22765417@N06,96,7,1351932912,1351943540,4,1,10628
22765417@N06,97,15,1356144437,1356147899,9,1,3462
22765417@N06,98,15,1366529082,1366531460,4,1,2378
22765417@N06,99,15,1375503202,1375503389,2,1,187
22765417@N06,100,15,1376174859,1376178226,6,1,3367
22765417@N06,101,25,1388729295,1388729610,3,1,315
22765417@N06,102,18,1393641979,1393645154,4,1,3175
22765417@N06,103,25,1394248720,1394252662,11,1,3942
22765417@N06,104,15,1395445617,1395451642,12,1,6025
22783145@N04,105,20,1258257067,1258257067,1,1,0
22896220@N05,106,27,1378611135,1378611135,1,1,0
23063899@N07,107,22,1303043983,1303043983,1,1,0
23063899@N07,108,5,1309584082,1309584082,1,1,0
23063899@N07,109,1,1321412201,1321412201,1,1,0
23090753@N06,110,6,1317612789,1317630487,26,1,17698
23090753@N06,111,6,1317668443,1317668443,1,1,0
23090753@N06,112,6,1317697675,1317698879,9,1,1204
23204349@N00,113,6,1239347307,1239350402,33,1,3095
23204349@N00,114,8,1239418685,1239419545,4,1,860
23386158@N00,115,24,1351913966,1351914568,2,1,602
23562237@N00,116,21,1242028909,1242028970,2,1,61
23562237@N00,117,5,1254603107,1254603107,1,1,0
23614242@N00,118,20,1195822340,1195822340,1,1,0
23850658@N06,119,20,1359602911,1359602911,1,1,0
23850658@N06,120,5,1385615650,1385615650,1,1,0
24328671@N07,121,16,1372921586,1372921586,1,1,0
24484507@N00,122,1,1178958177,1178958614,2,1,437
24484507@N00,123,5,1179059258,1179059258,1,1,0
24564553@N08,124,1,1264829001,1264836644,7,1,7643
24649145@N03,125,8,1333779359,1333786193,85,1,6834
24649145@N03,126,20,1333879494,1333879568,3,1,74
24670956@N04,127,11,1210969181,1210969181,1,1,0
24694600@N00,128,21,1298956397,1298956397,1,1,0
24896306@N00,129,1,915116400,915116400,1,1,0
24896306@N00,130,1,1199248173,1199260607,2,1,12434
24896306@N00,131,1,1383464859,1383468162,2,1,3303
25123696@N08,132,20,1288965026,1288965026,1,1,0
25368895@N00,133,8,1353736337,1353738422,4,1,2085
25501326@N02,134,10,1288710023,1288710023,1,1,0
25501326@N02,135,22,1288755824,1288770736,4,2,14912
25501326@N02,135,3,1288761445,1288765952,11,2,4507
25501326@N02,136,6,1294298312,1294298312,1,1,0
25501326@N02,137,7,1320286315,1320305338,12,1,19023
25501326@N02,138,8,1326000722,1326006119,13,1,5397
25501326@N02,139,22,1326195676,1326195689,2,1,13
25501326@N02,140,22,1364019261,1364019261,1,1,0
25549340@N00,141,8,1380953152,1380957432,7,1,4280
25619049@N04,142,24,1319951066,1319951066,1,1,0
25888083@N00,143,25,1211596776,1211596806,2,1,30
25888083@N00,144,7,1212911668,1212911711,2,1,43
25888083@N00,145,7,1224491176,1224491176,1,1,0
25888083@N00,146,16,1230867296,1230867296,1,1,0
25888083@N00,147,7,1248782346,1248782360,3,1,14
25888083@N00,148,25,1251769662,1251769670,2,1,8
25888083@N00,149,5,1260188679,1260188679,1,1,0
26400747@N03,150,6,1263089562,1263089562,1,1,0
26414679@N05,151,4,1292648406,1292673381,40,1,24975
26414679@N05,152,5,1300551679,1300551679,1,2,0
26414679@N05,152,28,1300548341,1300550305,3,2,1964
26456204@N07,153,21,1252740673,1252740673,1,1,0
26678013@N00,154,1,1204954109,1204961356,31,3,7247
26678013@N00,154,28,1204981775,1204981775,1,3,0
26678013@N00,154,2,1204953870,1204954005,4,3,135
26757052@N04,155,24,1348143273,1348143273,1,1,0
26775981@N05,156,21,1310107096,1310107096,1,1,0
26775981@N05,157,5,1321717806,1321717806,1,1,0
26989796@N03,158,20,1303984994,1303984994,1,1,0
27412055@N03,159,28,1397859355,1397859355,1,1,0
27568262@N00,160,8,1196137706,1196137706,1,2,0
27568262@N00,160,6,1196145683,1196153867,11,2,8184
27921677@N00,161,20,1206016367,1206017731,2,3,1364
27921677@N00,161,21,1206020399,1206020399,1,3,0
27921677@N00,161,5,1206006838,1206008304,5,3,1466
27921677@N00,162,1,1206070947,1206075241,19,2,4294
27921677@N00,162,2,1206069744,1206084033,8,2,14289
27921677@N00,163,21,1206114745,1206114800,2,1,55
27921677@N00,164,20,1206181111,1206183092,3,1,1981
28085557@N00,165,22,1284259299,1284260701,3,2,1402
28085557@N00,165,8,1284255524,1284255799,2,2,275
28808573@N04,166,4,1356235648,1356254571,5,1,18923
29200401@N03,167,4,1382878144,1382878144,1,1,0
29200401@N03,168,1,1382957151,1382957151,1,1,0
29242611@N05,169,20,1364897078,1364897078,1,1,0
29242611@N05,170,20,1365028998,1365029006,2,1,8
29242611@N05,171,20,1365158080,1365160699,4,1,2619
29242611@N05,172,20,1365204358,1365204358,1,1,0
29298454@N00,173,6,1341371882,1341371882,1,1,0
29298454@N00,174,7,1342779459,1342779459,1,1,0
29298454@N00,175,7,1344247892,1344247892,1,1,0
29298454@N00,176,7,1346405306,1346406852,2,1,1546
29664906@N04,177,6,1311682308,1311682308,1,1,0
29749840@N02,178,20,1346071252,1346077534,8,1,6282
29833755@N08,179,7,1296537132,1296537132,1,1,0
29925521@N06,180,6,1333161928,1333161928,1,1,0
29989965@N00,181,8,1325243257,1325244439,5,5,1182
29989965@N00,181,20,1325238565,1325238565,1,5,0
29989965@N00,181,1,1325209604,1325220228,34,5,10624
29989965@N00,181,22,1325225024,1325235844,10,5,10820
29989965@N00,181,2,1325208257,1325221651,6,5,13394
30099537@N02,182,2,1246480803,1246480803,1,1,0
30125839@N00,183,6,1384910815,1384916379,2,1,5564
30125839@N00,184,20,1385425529,1385425529,1,1,0
30254149@N02,185,6,1364637323,1364637323,1,1,0
30254149@N02,186,8,1364742649,1364742649,1,1,0
30447586@N00,187,7,1360746412,1360746412,1,1,0
30717090@N06,188,8,1255195573,1255199065,5,2,3492
30717090@N06,188,1,1255205038,1255211933,13,2,6895
30788820@N02,189,24,1382188652,1382189728,2,1,1076
30788820@N02,190,24,1382281677,1382281677,1,1,0
30806197@N02,191,6,1366277215,1366277215,1,1,0
30806197@N02,192,15,1366605895,1366605895,1,1,0
30983068@N06,193,24,1369609669,1369609669,1,1,0
30983068@N06,194,21,1369649233,1369649233,1,2,0
30983068@N06,194,20,1369649658,1369655645,3,2,5987
30983068@N06,195,20,1369738520,1369738551,3,2,31
30983068@N06,195,8,1369715028,1369715667,2,2,639
30983068@N06,196,22,1369819271,1369825282,15,1,6011
30983068@N06,197,28,1370079181,1370083789,8,2,4608
30983068@N06,197,5,1370074493,1370075003,3,2,510
30983068@N06,198,6,1370137768,1370137768,1,1,0
30983068@N06,199,28,1370171497,1370171497,1,1,0
30983068@N06,200,6,1370245357,1370245357,1,1,0
31338008@N08,201,21,1339476714,1339476714,1,1,0
31484513@N00,202,24,1289668776,1289668776,1,1,0
31484513@N00,203,21,1289702228,1289702228,1,1,0
31484513@N00,204,7,1293178015,1293178181,2,1,166
31484513@N00,205,1,1293248472,1293248472,1,1,0
31484513@N00,206,21,1293320608,1293320608,1,2,0
31484513@N00,206,25,1293342555,1293342555,1,2,0
31484513@N00,207,28,1299233892,1299241650,2,1,7758
31484513@N00,208,24,1299399608,1299399608,1,1,0
31484513@N00,209,18,1311477594,1311499227,3,1,21633
31484513@N00,210,18,1311598415,1311598677,2,1,262
31484513@N00,211,20,1312692300,1312692300,1,1,0
31484513@N00,212,8,1314529986,1314529986,1,1,0
31484513@N00,213,10,1316415108,1316418098,2,1,2990
31484513@N00,214,7,1316764417,1316764417,1,1,0
31484513@N00,215,15,1317530000,1317532826,4,1,2826
31484513@N00,216,21,1317913001,1317913001,1,1,0
31484513@N00,217,21,1318137474,1318137684,2,1,210
31484513@N00,218,7,1319342043,1319342670,4,1,627
31484513@N00,219,7,1319627390,1319627390,1,1,0
31484513@N00,220,18,1319872508,1319873788,2,1,1280
31484513@N00,221,5,1321683672,1321683672,1,1,0
31484513@N00,222,28,1322300390,1322302738,3,1,2348
31484513@N00,223,5,1324125137,1324125137,1,1,0
31484513@N00,224,7,1324195452,1324195452,1,1,0
31484513@N00,225,20,1324706847,1324707596,2,2,749
31484513@N00,225,21,1324705719,1324709175,2,2,3456
31484513@N00,226,18,1325349268,1325349268,1,1,0
31484513@N00,227,22,1327726548,1327737498,6,1,10950
31484513@N00,228,8,1333719793,1333719793,1,1,0
31484513@N00,229,20,1336803476,1336822331,3,1,18855
31484513@N00,230,28,1338640609,1338650694,5,1,10085
31484513@N00,231,22,1339748466,1339748466,1,1,0
31484513@N00,232,6,1339832815,1339847328,4,1,14513
31484513@N00,233,23,1340347473,1340347473,1,1,0
31484513@N00,234,8,1340451913,1340451913,1,1,0
31484513@N00,235,20,1342162575,1342184942,3,1,22367
31484513@N00,236,8,1343419450,1343421550,2,1,2100
31484513@N00,237,7,1350045000,1350053839,4,1,8839
31484513@N00,238,7,1350114990,1350115838,3,1,848
31484513@N00,239,22,1350195382,1350195423,2,3,41
31484513@N00,239,7,1350207003,1350207003,1,3,0
31484513@N00,239,10,1350188955,1350194177,2,3,5222
31484513@N00,240,28,1350655393,1350658659,3,1,3266
31484513@N00,241,7,1350913280,1350913280,1,1,0
31484513@N00,242,6,1354359165,1354359165,1,1,0
31484513@N00,243,10,1359786108,1359786108,1,1,0
31784544@N00,244,20,1257845581,1257845581,1,1,0
32006782@N00,245,8,1384874438,1384874560,2,2,122
32006782@N00,245,21,1384896754,1384903003,3,2,6249
32006782@N00,246,21,1384965032,1384965032,1,1,0
32006782@N00,247,21,1384995690,1384995690,1,1,0
32006782@N00,248,20,1385160983,1385166589,3,1,5606
32006782@N00,249,6,1385476969,1385476969,1,2,0
32006782@N00,249,21,1385476851,1385476851,1,2,0
32006782@N00,250,8,1385587854,1385587854,1,1,0
32635026@N00,251,15,1296362000,1296366397,10,1,4397
32697239@N04,252,1,1381299673,1381299673,1,1,0
32877343@N07,253,6,1191670840,1191671182,2,1,342
32877343@N07,254,22,1191720582,1191720582,1,1,0
32884848@N07,255,18,1145770280,1145771350,10,2,1070
32884848@N07,255,8,1145777615,1145778107,2,2,492
32884848@N07,256,10,1145927653,1145928326,4,2,673
32884848@N07,256,22,1145929025,1145932020,13,2,2995
33048476@N08,257,16,1299290730,1299290730,1,1,0
33195821@N00,258,8,1112281200,1112281200,1,1,0
33624291@N04,259,16,1386374575,1386374606,3,1,31
33634478@N00,260,18,1294124634,1294124953,2,1,319
33634478@N00,261,21,1294217564,1294217564,1,1,0
33634478@N00,262,18,1294373047,1294373498,5,1,451
33634478@N00,263,18,1294893684,1294893684,1,2,0
33634478@N00,263,15,1294896671,1294897308,5,2,637
33634478@N00,264,5,1295436608,1295449008,3,1,12400
33634478@N00,265,5,1295946755,1295946755,1,1,0
33634478@N00,266,21,1298189306,1298189306,1,1,0
33634478@N00,267,2,1298977777,1298977958,2,1,181
33634478@N00,268,7,1300164144,1300166418,2,1,2274
33634478@N00,269,15,1300675996,1300677081,3,2,1085
33634478@N00,269,20,1300688607,1300688607,1,2,0
33634478@N00,270,7,1304743590,1304743590,1,1,0
33634478@N00,271,7,1315803362,1315803362,1,1,0
33634478@N00,272,5,1317193815,1317193815,1,1,0
33634478@N00,273,7,1319612553,1319614854,2,1,2301
33634478@N00,274,21,1320837865,1320837865,1,1,0
33634478@N00,275,21,1322545828,1322545828,1,1,0
33634478@N00,276,21,1323508057,1323508057,1,1,0
33634478@N00,277,20,1325754276,1325754276,1,1,0
33634478@N00,278,7,1348638641,1348638641,1,1,0
33634478@N00,279,6,1383982550,1383982550,1,1,0
33634478@N00,280,18,1389340660,1389341698,2,1,1038
33752889@N08,281,21,1283836119,1283845030,17,1,8911
33817101@N02,282,6,1239388029,1239389839,27,1,1810
33888437@N06,283,22,1249987707,1249987707,1,1,0
34850133@N03,284,4,1254538080,1254538080,1,1,0
34977761@N06,285,25,1299036220,1299045363,5,1,9143
34977761@N06,286,7,1335423926,1335423926,1,1,0
35028640@N00,287,2,1116549945,1116549945,1,1,0
35034349721@N01,288,6,1289115569,1289115569,1,1,0
35034350382@N01,289,1,1252336471,1252338639,16,1,2168
35034350382@N01,290,1,1252422588,1252423225,8,1,637
35043861@N08,291,1,1233241200,1233241212,13,1,12
35043861@N08,292,4,1233327616,1233327616,1,1,0
35180387@N04,293,4,1353283929,1353317091,24,1,33162
35336901@N00,294,21,1285213811,1285213811,1,1,0
35336901@N00,295,18,1294133749,1294133749,1,1,0
35336901@N00,296,2,1299020241,1299020241,1,1,0
35336901@N00,297,7,1319612239,1319614876,2,1,2637
35391423@N00,298,8,1334113369,1334114734,4,4,1365
35391423@N00,298,5,1334143148,1334144340,3,4,1192
35391423@N00,298,1,1334126823,1334126823,1,4,0
35391423@N00,298,2,1334131056,1334135104,6,4,4048
35391423@N00,299,21,1334224135,1334224135,1,1,0
35391423@N00,300,5,1334286427,1334286489,2,2,62
35391423@N00,300,6,1334289329,1334293448,5,2,4119
35391423@N00,301,1,1334452701,1334455794,17,2,3093
35391423@N00,301,2,1334451695,1334451871,4,2,176
35955268@N00,302,22,1258261869,1258261869,1,1,0
36064583@N03,303,20,1378297672,1378297672,1,1,0
36064583@N03,304,20,1382797810,1382797810,1,1,0
36064583@N03,305,20,1394675323,1394675323,1,1,0
36093266@N06,306,8,1322633973,1322633989,3,1,16
36093266@N06,307,8,1322673170,1322673204,2,1,34
36328344@N04,308,8,1316183926,1316184428,3,1,502
36330824413@N01,309,5,1352648568,1352648568,1,3,0
36330824413@N01,309,21,1352648465,1352648465,1,3,0
36330824413@N01,309,8,1352621522,1352623654,5,3,2132
36330824413@N01,310,5,1352710119,1352711713,4,1,1594
36362496@N02,311,22,1334188839,1334188839,1,1,0
36516818@N00,312,21,1139125827,1139125827,1,1,0
36521977832@N01,313,28,1334366878,1334366878,1,1,0
36521977832@N01,314,6,1334610090,1334610090,1,1,0
36521984920@N01,315,1,1236931603,1236931603,1,1,0
36521984920@N01,316,28,1250338186,1250338189,2,2,3
36521984920@N01,316,21,1250331543,1250333700,5,2,2157
36521984920@N01,317,5,1250434095,1250461478,2,1,27383
36521984920@N01,318,8,1292988091,1292988091,1,2,0
36521984920@N01,318,7,1292984401,1292984401,1,2,0
36521984920@N01,319,7,1293019974,1293021831,5,1,1857
36521984920@N01,320,1,1293076570,1293094043,10,2,17473
36521984920@N01,320,2,1293076265,1293076265,1,2,0
36749444@N06,321,21,1388058834,1388061275,3,1,2441
36791303@N00,322,19,1357730051,1357730613,8,1,562
36856587@N00,323,1,1232939355,1232959117,6,1,19762
36856587@N00,324,1,1233148361,1233148455,2,1,94
36856587@N00,325,1,1294118971,1294136028,8,1,17057
36856587@N00,326,22,1348295626,1348295626,1,1,0
36856587@N00,327,22,1385881009,1385886156,5,1,5147
36976184@N02,328,3,1241397697,1241397697,1,2,0
36976184@N02,328,22,1241397607,1241397607,1,2,0
37029412@N00,329,20,1360723266,1360723266,1,1,0
37346774@N00,330,23,1371487397,1371487397,1,1,0
37346774@N00,331,23,1371534974,1371534979,2,1,5
37346774@N00,332,8,1371635459,1371635459,1,1,0
38227973@N07,333,20,1367627230,1367627230,1,1,0
38235150@N00,334,2,1189538238,1189545922,4,3,7684
38235150@N00,334,1,1189539191,1189543810,7,3,4619
38235150@N00,334,8,1189552698,1189552698,1,3,0
38235150@N00,335,20,1239082935,1239085754,2,1,2819
39294044@N00,336,7,1180005162,1180005162,1,1,0
39294044@N00,337,21,1181027111,1181027111,1,1,0
39294044@N00,338,21,1293801313,1293808524,3,1,7211
39471887@N06,339,1,1351472128,1351472128,1,1,0
39952962@N00,340,1,1224192077,1224196123,18,2,4046
39952962@N00,340,2,1224191657,1224191657,1,2,0
39952962@N00,341,20,1225425192,1225425192,1,1,0
39952962@N00,342,8,1364374494,1364374665,2,1,171
39975399@N00,343,1,1288055691,1288065023,3,1,9332
40037997@N02,344,23,1270792492,1270792684,2,2,192
40037997@N02,344,20,1270796832,1270796832,1,2,0
40037997@N02,345,27,1294627913,1294627913,1,1,0
40295335@N00,346,20,1343555111,1343558023,5,1,2912
40461160@N00,347,20,1081417538,1081417538,1,1,0
40461160@N00,348,1,1142144488,1142148887,3,2,4399
40461160@N00,348,2,1142158695,1142159488,2,2,793
40461160@N00,349,2,1142397604,1142397642,2,1,38
40461160@N00,350,20,1144508335,1144508335,1,1,0
40461160@N00,351,1,1147401096,1147401096,1,2,0
40461160@N00,351,2,1147401162,1147401248,2,2,86
40461160@N00,352,2,1147689118,1147689118,1,1,0
40461160@N00,353,2,1147896316,1147896316,1,1,0
40461160@N00,354,24,1153900313,1153900313,1,1,0
40524562@N00,355,6,1368781696,1368782677,2,1,981
40689324@N00,356,20,1321698180,1321698180,1,1,0
40741666@N05,357,5,1284693946,1284694438,4,1,492
40772617@N07,358,20,1186799386,1186799913,3,2,527
40772617@N07,358,8,1186790666,1186790666,1,2,0
40866968@N06,359,6,1343187555,1343207568,62,1,20013
41392618@N06,360,5,1388052079,1388052553,2,1,474
41392618@N06,361,8,1388107189,1388113040,8,2,5851
41392618@N06,361,1,1388121998,1388129254,11,2,7256
41445350@N00,362,24,1246633150,1246633150,1,1,0
41786434@N04,363,19,1279352167,1279352809,2,1,642
41786434@N04,364,18,1280100927,1280100927,1,1,0
41786434@N04,365,7,1355482964,1355482964,1,1,0
41819939@N00,366,21,1111191061,1111191061,1,1,0
41819939@N00,367,8,1112935744,1112935744,3,1,0
41819939@N00,368,8,1121386025,1121386047,2,1,22
41894166489@N01,369,21,1351219367,1351219367,1,1,0
41894166489@N01,370,21,1351308314,1351308314,1,2,0
41894166489@N01,370,20,1351308394,1351308394,1,2,0
41894166489@N01,371,1,1351385507,1351400682,6,1,15175
41894168898@N01,372,8,1379058797,1379058797,1,1,0
42078772@N00,373,8,1289029840,1289030099,2,1,259
42078772@N00,374,21,1318545192,1318555803,3,1,10611
42078772@N00,375,21,1331857113,1331857113,1,1,0
42078772@N00,376,22,1336127186,1336127186,1,1,0
42078772@N00,377,21,1348203541,1348203541,1,1,0
42117243@N00,378,20,1212045726,1212047821,12,1,2095
42117243@N00,379,4,1212104256,1212133029,126,1,28773
42117243@N00,380,22,1212304875,1212307259,30,2,2384
42117243@N00,380,8,1212296415,1212297333,20,2,918
42620619@N05,381,25,1270554260,1270554260,1,1,0
42620619@N05,382,6,1274874002,1274874002,1,1,0
42740044@N05,383,5,1364029267,1364029267,1,1,0
43113903@N00,384,24,1334387323,1334390812,3,1,3489
43113903@N00,385,21,1348837503,1348837503,1,1,0
43113903@N00,386,24,1355737786,1355738739,2,1,953
43113903@N00,387,22,1359625553,1359631666,18,1,6113
43113903@N00,388,24,1360847449,1360848151,2,1,702
43113903@N00,389,28,1361006093,1361006093,1,2,0
43113903@N00,389,21,1361012902,1361012902,1,2,0
43113903@N00,390,21,1361278255,1361278255,1,1,0
43113903@N00,391,21,1366203889,1366203889,1,1,0
43113903@N00,392,21,1366452611,1366452611,1,1,0
43113903@N00,393,24,1372493037,1372493037,1,1,0
43515091@N08,394,8,1257976129,1257976129,1,1,0
43742518@N03,395,21,1317982683,1317983181,5,1,498
43742518@N03,396,7,1319963023,1319964394,18,1,1371
43742518@N03,397,10,1365051736,1365053172,21,1,1436
43742518@N03,398,3,1378627634,1378629958,7,2,2324
43742518@N03,398,10,1378630726,1378630726,1,2,0
43742518@N03,399,3,1380955932,1380958097,8,1,2165
43742518@N03,400,8,1387087756,1387087756,1,2,0
43742518@N03,400,7,1387106282,1387108685,12,2,2403
43742518@N03,401,7,1387801568,1387801568,1,1,0
43749456@N05,402,6,1366698563,1366705027,6,4,6464
43749456@N05,402,15,1366673070,1366673714,2,4,644
43749456@N05,402,1,1366688863,1366691669,4,4,2806
43749456@N05,402,8,1366679297,1366679297,1,4,0
43754375@N00,403,21,1385196357,1385204028,10,1,7671
43754375@N00,404,18,1385255097,1385255097,1,1,0
43754375@N00,405,5,1385371530,1385372282,6,1,752
43754375@N00,406,20,1385601000,1385601000,1,1,0
43935389368@N01,407,6,1378117845,1378117845,1,1,0
43935389368@N01,408,6,1378353135,1378370725,2,1,17590
43935389368@N01,409,6,1378439471,1378439471,1,1,0
44124291728@N01,410,20,1355029288,1355029288,1,2,0
44124291728@N01,410,21,1355030683,1355031145,2,2,462
44124291728@N01,411,6,1355210935,1355215730,7,1,4795
44124291728@N01,412,8,1355287787,1355288095,2,1,308
44124362019@N01,413,10,1219798344,1219798455,3,2,111
44124362019@N01,413,3,1219804651,1219807699,8,2,3048
44124450615@N01,414,21,1224734576,1224734576,1,2,0
44124450615@N01,414,20,1224734982,1224734982,1,2,0
44152183@N07,415,20,1348746728,1348749730,9,1,3002
44152183@N07,416,8,1349327902,1349328705,3,2,803
44152183@N07,416,20,1349320305,1349321406,4,2,1101
44613915@N00,417,8,1138579005,1138587276,37,1,8271
44789177@N08,418,8,1269769038,1269769038,1,1,0
44926895@N07,419,4,1371365416,1371366199,5,1,783
44926895@N07,420,28,1371736324,1371736324,1,1,0
44926895@N07,421,8,1371794737,1371798692,10,4,3955
44926895@N07,421,25,1371780543,1371780552,2,4,9
44926895@N07,421,20,1371819696,1371819696,1,4,0
44926895@N07,421,22,1371811656,1371812561,8,4,905
44926895@N07,422,20,1371906389,1371906391,2,2,2
44926895@N07,422,21,1371907886,1371907886,1,2,0
44926895@N07,423,18,1373187831,1373189899,26,1,2068
44926895@N07,424,18,1374572666,1374572731,2,1,65
44926895@N07,425,18,1374651954,1374658845,59,1,6891
44926895@N07,426,18,1374733934,1374744496,74,1,10562
44926895@N07,427,4,1379310948,1379311517,21,1,569
44954349@N00,428,6,1334199739,1334199842,2,1,103
44954349@N00,429,20,1334470442,1334470474,2,1,32
44966693@N00,430,8,1288424839,1288425498,4,1,659
44966693@N00,431,1,1288493314,1288495504,7,1,2190
45335371@N00,432,8,1366377305,1366378493,10,2,1188
45335371@N00,432,1,1366378649,1366379466,6,2,817
45541732@N06,433,15,1336856925,1336856925,1,1,0
45541732@N06,434,15,1336886629,1336894031,11,1,7402
46464136@N00,435,2,1252210874,1252210874,1,1,0
47173486@N00,436,5,1331299914,1331299914,1,2,0
47173486@N00,436,28,1331288967,1331296489,6,2,7522
47335063@N08,437,2,1258794758,1258802421,17,2,7663
47335063@N08,437,1,1258795058,1258800493,107,2,5435
47335063@N08,438,5,1263034402,1263034402,1,1,0
47335063@N08,439,18,1263182506,1263184027,24,1,1521
47335063@N08,440,18,1279974715,1279975707,17,1,992
47379538@N00,441,8,1288748112,1288751055,7,2,2943
47379538@N00,441,20,1288763815,1288763815,1,2,0
47379538@N00,442,20,1289132338,1289132338,1,1,0
47573122@N05,443,8,1345875803,1345880740,38,2,4937
47573122@N05,443,23,1345897671,1345897671,1,2,0
47843154@N07,444,22,1395402849,1395402849,1,1,0
47957339@N00,445,7,1351631021,1351631246,2,3,225
47957339@N00,445,5,1351609414,1351630448,2,3,21034
47957339@N00,445,28,1351616528,1351616528,1,3,0
48009694@N00,446,6,1073893432,1073894332,11,1,900
48009694@N00,447,6,1325399468,1325406427,7,1,6959
48009694@N00,448,6,1325462391,1325462391,1,1,0
48009694@N00,449,22,1325556716,1325557976,49,1,1260
48009694@N00,450,6,1325633301,1325633305,2,1,4
48182578@N00,451,8,1366459871,1366459871,1,1,0
48338222@N05,452,8,1270717121,1270717121,1,1,0
48355243@N00,453,5,1397850294,1397855245,5,1,4951
48566562@N06,454,6,1339911970,1339912770,3,2,800
48566562@N06,454,8,1339901062,1339904296,6,2,3234
48566562@N06,455,1,1339976622,1339984414,2,1,7792
49071064@N00,456,5,1313202363,1313203633,3,1,1270
49296659@N00,457,8,1206423964,1206423964,1,1,0
49296659@N00,458,8,1206831596,1206831596,1,1,0
49296659@N00,459,8,1206913802,1206913802,1,1,0
49296659@N00,460,8,1207004278,1207015249,4,1,10971
49395947@N00,461,19,1225091953,1225092162,2,1,209
49395947@N00,462,12,1225593937,1225593937,1,1,0
49395947@N00,463,19,1252137980,1252138121,2,2,141
49395947@N00,463,21,1252127054,1252134530,4,2,7476
49395947@N00,464,21,1326264693,1326264693,1,1,0
49395947@N00,465,21,1326849120,1326849325,2,1,205
49395947@N00,466,21,1327627361,1327627361,1,1,0
49395947@N00,467,21,1328664296,1328666890,3,1,2594
49395947@N00,468,21,1328859029,1328859029,1,1,0
49395947@N00,469,12,1333518740,1333521977,3,1,3237
49395947@N00,470,21,1348638169,1348639285,2,1,1116
49395947@N00,471,28,1353745957,1353745957,1,1,0
49395947@N00,472,12,1359790785,1359790785,1,1,0
49395947@N00,473,21,1360638977,1360638977,1,1,0
49395947@N00,474,6,1372822411,1372822411,1,1,0
49395947@N00,475,28,1373362058,1373362058,1,1,0
49395947@N00,476,19,1376373092,1376373092,1,1,0
49395947@N00,477,21,1381997640,1381997640,1,1,0
49395947@N00,478,28,1384591125,1384591125,1,1,0
49395947@N00,479,3,1395537689,1395546097,3,1,8408
49395947@N00,480,5,1396329187,1396329187,1,1,0
49462908@N00,481,6,1215755513,1215756000,3,5,487
49462908@N00,481,24,1215775255,1215775255,1,5,0
49462908@N00,481,20,1215763517,1215777799,10,5,14282
49462908@N00,481,5,1215751277,1215759862,4,5,8585
49462908@N00,481,23,1215766535,1215768512,3,5,1977
49462908@N00,482,1,1216194722,1216194984,8,2,262
49462908@N00,482,2,1216194541,1216198149,7,2,3608
49462908@N00,483,2,1343606689,1343606689,1,1,0
49708294@N07,484,22,1386556641,1386556641,1,1,0
49787588@N00,485,5,1373489282,1373489755,2,1,473
49787588@N00,486,2,1373550098,1373550098,1,1,0
49895655@N06,487,21,1349259061,1349259061,1,1,0
49895655@N06,488,20,1349322009,1349322009,1,1,0
49948988@N03,489,25,1316387930,1316387930,1,1,0
49948988@N03,490,5,1334377701,1334377701,1,1,0
49968453@N02,491,11,1312685088,1312687411,7,1,2323
49968453@N02,492,11,1316336694,1316336694,1,1,0
49968453@N02,493,5,1318048210,1318048210,1,1,0
49968453@N02,494,21,1318144409,1318144827,3,2,418
49968453@N02,494,11,1318128118,1318129136,2,2,1018
49968453@N02,495,24,1318745435,1318745435,1,1,0
49968453@N02,496,11,1319339083,1319340327,2,1,1244
49968453@N02,497,11,1319938884,1319940081,3,1,1197
49968453@N02,498,11,1321669542,1321670347,8,1,805
49968453@N02,499,11,1322284217,1322284276,2,1,59
49968453@N02,500,7,1323954258,1323954258,1,1,0
49968453@N02,501,21,1324093039,1324093055,2,2,16
49968453@N02,501,7,1324104565,1324104565,1,2,0
49968453@N02,502,21,1324181270,1324181270,1,1,0
49968453@N02,503,11,1327138217,1327138217,1,1,0
49968453@N02,504,11,1334469559,1334472423,2,1,2864
49968453@N02,505,21,1336193905,1336193905,1,1,0
49968453@N02,506,11,1337920023,1337920023,1,2,0
49968453@N02,506,5,1337947311,1337947311,1,2,0
49968453@N02,507,11,1338003049,1338003502,3,2,453
49968453@N02,507,24,1338011753,1338012237,3,2,484
49968453@N02,508,11,1342832188,1342850551,2,1,18363
49968453@N02,509,22,1343542788,1343542788,1,1,0
49968453@N02,510,28,1344512610,1344517768,4,1,5158
49968453@N02,511,11,1368924805,1368931294,13,1,6489
50038401@N02,512,20,1380627857,1380634807,72,1,6950
50038401@N02,513,8,1380696502,1380699427,17,1,2925
50046321@N08,514,18,1302940820,1302940820,1,1,0
50046321@N08,515,29,1358230728,1358230728,1,1,0
50046321@N08,516,6,1361258485,1361258485,1,1,0
50507715@N00,517,24,1181377267,1181377267,1,1,0
50879288@N06,518,11,1353933407,1353935011,2,1,1604
50893125@N03,519,24,1276345501,1276345501,1,1,0
50893125@N03,520,7,1346123461,1346123461,1,1,0
50893125@N03,521,11,1346316853,1346316853,1,1,0
50893125@N03,522,11,1346815683,1346815683,1,1,0
51035640596@N01,523,8,1333627497,1333631556,6,1,4059
51035640596@N01,524,4,1333799278,1333799278,1,1,0
51035737977@N01,525,1,1383498337,1383498337,1,1,0
51035737977@N01,526,8,1383603012,1383603012,1,3,0
51035737977@N01,526,6,1383586423,1383586423,1,3,0
51035737977@N01,526,20,1383562137,1383562137,1,3,0
52013277@N02,527,8,1379297606,1379297606,1,1,0
52043939@N00,528,6,1384601311,1384601340,3,1,29
52043939@N00,529,1,1384749019,1384750974,13,1,1955
52147872@N00,530,21,1262595251,1262595251,1,1,0
52527003@N00,531,8,1065054305,1065054437,2,2,132
52527003@N00,531,6,1065080975,1065082553,6,2,1578
52585985@N06,532,8,1337627521,1337627521,1,1,0
53064522@N00,533,1,1247188977,1247201954,21,1,12977
53064522@N00,534,1,1314840366,1314845564,9,1,5198
53064522@N00,535,1,1386464383,1386471777,8,2,7394
53064522@N00,535,2,1386463529,1386463529,1,2,0
53289105@N00,536,22,1311317268,1311317539,3,5,271
53289105@N00,536,23,1311314602,1311315788,2,5,1186
53289105@N00,536,8,1311293790,1311299853,7,5,6063
53289105@N00,536,21,1311303708,1311339490,4,5,35782
53289105@N00,536,10,1311317977,1311320603,5,5,2626
53289105@N00,537,7,1311467957,1311468369,2,2,412
53289105@N00,537,18,1311460149,1311464037,14,2,3888
53289105@N00,538,18,1311576633,1311582078,27,2,5445
53289105@N00,538,23,1311559514,1311563226,4,2,3712
53289105@N00,539,21,1386501482,1386501493,2,2,11
53289105@N00,539,16,1386474434,1386475780,8,2,1346
54164862@N00,540,6,1369696664,1369696664,1,1,0
54164862@N00,541,21,1369736442,1369736504,3,1,62
54164862@N00,542,6,1369816582,1369823994,9,1,7412
54164862@N00,543,4,1369873064,1369901020,72,1,27956
54164862@N00,544,6,1370329514,1370329514,1,2,0
54164862@N00,544,21,1370328082,1370328085,2,2,3
54511827@N00,545,8,1391907285,1391921917,7,1,14632
54895718@N04,546,8,1354150917,1354158941,9,1,8024
55258922@N00,547,4,1280746442,1280749684,30,1,3242
55258922@N00,548,4,1280799939,1280799939,1,1,0
55299380@N00,549,5,1345202648,1345203376,2,1,728
55299380@N00,550,25,1347185466,1347185466,1,1,0
55299380@N00,551,6,1354246738,1354246738,3,1,0
55299380@N00,552,3,1357439587,1357441276,2,1,1689
55299380@N00,553,28,1367657226,1367657226,1,1,0
55299380@N00,554,6,1376282043,1376282043,3,1,0
55299380@N00,555,6,1379402956,1379406354,14,1,3398
55299380@N00,556,6,1380271475,1380271604,6,1,129
55299380@N00,557,6,1380843725,1380843842,13,1,117
55299380@N00,558,6,1380958192,1380958292,3,2,100
55299380@N00,558,5,1380960169,1380960205,2,2,36
55299380@N00,559,6,1384213546,1384213656,3,1,110
55299380@N00,560,5,1391750029,1391750029,1,1,0
55464987@N07,561,20,1309440400,1309440400,1,2,0
55464987@N07,561,5,1309440404,1309440404,1,2,0
56391571@N00,562,1,1184376729,1184377323,3,1,594
56391571@N00,563,3,1184553012,1184553934,2,1,922
56413961@N00,564,8,1230862416,1230862416,1,1,0
56541240@N00,565,20,1225914782,1225927332,29,1,12550
56541240@N00,566,8,1226155869,1226159077,13,1,3208
56638827@N00,567,20,1305948170,1305948340,12,1,170
56638827@N00,568,28,1328837281,1328837281,1,1,0
56728000@N00,569,8,1338372453,1338372453,1,1,0
56728000@N00,570,22,1338439759,1338439759,1,1,0
56745428@N00,571,20,1337387620,1337387620,1,1,0
56745428@N00,572,21,1337435137,1337435137,1,2,0
56745428@N00,572,8,1337450818,1337450818,1,2,0
56745428@N00,573,21,1351352076,1351352076,1,1,0
56745428@N00,574,4,1352578263,1352578263,1,1,0
56745428@N00,575,8,1376256988,1376256988,1,2,0
56745428@N00,575,1,1376234591,1376234591,1,2,0
56886057@N00,576,5,1234663924,1234663924,1,1,0
56944727@N00,577,6,1206697732,1206697732,1,3,0
56944727@N00,577,20,1206678171,1206678171,1,3,0
56944727@N00,577,8,1206688605,1206688605,1,3,0
56952133@N07,578,21,1361098666,1361098666,1,2,0
56952133@N07,578,20,1361101309,1361101309,1,2,0
56996210@N06,579,5,1380853354,1380853354,1,1,0
57201841@N03,580,22,1327473023,1327473023,1,1,0
57201841@N03,581,21,1327554840,1327554840,1,1,0
57604326@N03,582,15,1366671928,1366674830,6,1,2902
57604326@N03,583,6,1380805516,1380805516,1,1,0
58122747@N00,584,24,1247330113,1247330472,10,1,359
58122747@N00,585,28,1261845688,1261845688,1,2,0
58122747@N00,585,23,1261831227,1261831227,1,2,0
58122747@N00,586,21,1265458616,1265463942,6,2,5326
58122747@N00,586,24,1265458613,1265458613,1,2,0
58122747@N00,587,23,1271562207,1271567739,2,1,5532
58122747@N00,588,23,1272463143,1272465488,2,1,2345
58122747@N00,589,24,1272538088,1272538088,1,1,0
58165732@N00,590,20,1262248699,1262248699,1,2,0
58165732@N00,590,22,1262243169,1262243169,1,2,0
58255533@N03,591,20,1299300787,1299300787,1,1,0
58781173@N00,592,20,1290513829,1290515558,4,1,1729
59024453@N06,593,5,1311489497,1311489936,4,1,439
59380041@N07,594,5,1367317110,1367321044,2,2,3934
59380041@N07,594,28,1367314662,1367314662,1,2,0
60711235@N00,595,25,1393050420,1393050420,1,1,0
60855282@N08,596,22,1312635646,1312635646,1,1,0
60855282@N08,597,20,1312887397,1312887397,1,1,0
60855282@N08,598,4,1312945385,1312971657,31,1,26272
60855282@N08,599,20,1363345133,1363345133,1,1,0
61336814@N07,600,8,1292905488,1292905488,1,1,0
61478317@N06,601,3,1305956971,1305958815,7,1,1844
61478317@N06,602,1,1312695942,1312695942,1,1,0
61478317@N06,603,1,1313051250,1313051250,1,2,0
61478317@N06,603,2,1313051449,1313051449,1,2,0
61585804@N00,604,8,1301873878,1301888150,400,1,14272
61585804@N00,605,3,1301966405,1302003447,482,1,37042
61585804@N00,606,10,1323924798,1323959128,347,1,34330
61925460@N00,607,19,1350693739,1350693739,1,1,0
61932398@N00,608,7,1309532629,1309532629,1,1,0
61937148@N00,609,8,1377315415,1377315580,2,1,165
61953669@N00,610,20,1375427714,1375427714,1,1,0
61953669@N00,611,22,1375508459,1375508459,1,1,0
62388035@N07,612,21,1310132338,1310132338,1,1,0
62388035@N07,613,20,1315728016,1315728016,1,1,0
62388035@N07,614,11,1318749378,1318749378,1,1,0
62705531@N00,615,20,1227349137,1227356756,2,1,7619
62897163@N00,616,12,1316322971,1316322971,1,1,0
62897163@N00,617,1,1316393908,1316398202,18,2,4294
62897163@N00,617,8,1316401421,1316405206,9,2,3785
62929416@N00,618,16,1379585371,1379585371,1,1,0
62929416@N00,619,20,1379682284,1379682284,1,1,0
62942199@N08,620,8,1304475275,1304495637,8,1,20362
62942199@N08,621,5,1392028393,1392028418,2,1,25
63282110@N00,622,21,1353235530,1353235530,1,3,0
63282110@N00,622,15,1353212240,1353212240,1,3,0
63282110@N00,622,24,1353206129,1353206129,1,3,0
63282110@N00,623,6,1353319221,1353321059,5,1,1838
63282110@N00,624,21,1353492569,1353492569,1,1,0
63282110@N00,625,21,1353541783,1353541783,1,1,0
63522147@N00,626,1,888667873,888667873,1,1,0
63706780@N03,627,3,1355239063,1355239071,3,1,8
63766699@N00,628,3,1195872790,1195872790,1,1,0
63974906@N00,629,6,1289633543,1289633543,1,1,0
63974906@N00,630,5,1290914311,1290914311,1,1,0
63974906@N00,631,24,1326002791,1326002791,1,1,0
63974906@N00,632,21,1326608353,1326608353,1,1,0
64015960@N00,633,8,1315885871,1315885871,1,1,0
64651023@N00,634,5,1095308808,1095309326,2,1,518
64651023@N00,635,1,1095479254,1095485393,3,2,6139
64651023@N00,635,2,1095478976,1095478976,1,2,0
64651023@N00,636,6,1155559975,1155559975,1,1,0
64651023@N00,637,1,1155592432,1155592432,1,1,0
64667184@N02,638,24,1368930665,1368935931,40,3,5266
64667184@N02,638,20,1368929908,1368930012,3,3,104
64667184@N02,638,5,1368956644,1368956838,4,3,194
65070919@N02,639,6,1385635561,1385642247,3,2,6686
65070919@N02,639,20,1385630149,1385648384,2,2,18235
65070919@N02,640,8,1385688703,1385688703,1,2,0
65070919@N02,640,16,1385700137,1385703178,2,2,3041
65847118@N06,641,1,1285301001,1285307373,13,2,6372
65847118@N06,641,8,1285315365,1285315365,1,2,0
66172503@N00,642,8,1378003517,1378003830,2,1,313
67161842@N00,643,25,1287535525,1287535525,1,1,0
67340503@N05,644,28,1356344977,1356344977,1,1,0
67387917@N04,645,2,1274061054,1274061054,1,1,0
67666998@N00,646,24,1382438057,1382443063,3,1,5006
67666998@N00,647,24,1382529550,1382529550,1,2,0
67666998@N00,647,21,1382529469,1382529469,1,2,0
67666998@N00,648,21,1382582094,1382596775,6,1,14681
67666998@N00,649,24,1382650478,1382650478,1,1,0
67917860@N00,650,20,1198058317,1198059393,9,1,1076
68009656@N00,651,8,1307814414,1307814414,1,1,0
68089733@N00,652,2,1291896534,1291896898,5,1,364
68089733@N00,653,1,1291948046,1291951271,3,3,3225
68089733@N00,653,2,1291946330,1291947844,4,3,1514
68089733@N00,653,5,1291941648,1291941648,1,3,0
68089733@N00,654,2,1296880072,1296880072,1,3,0
68089733@N00,654,1,1296861768,1296863165,2,3,1397
68089733@N00,654,20,1296895903,1296899296,2,3,3393
68473409@N00,655,7,1315667885,1315667885,1,1,0
68473409@N00,656,18,1327740793,1327740793,1,1,0
68473409@N00,657,22,1332654859,1332659610,3,1,4751
68473409@N00,658,24,1342943877,1342943877,1,1,0
68686790@N00,659,20,1379533184,1379533184,1,1,0
68743756@N00,660,21,1398523722,1398523913,3,1,191
69902437@N00,661,20,1379585614,1379585614,1,1,0
69902437@N00,662,16,1379989304,1379989321,2,1,17
70323761@N00,663,6,1305705112,1305705150,2,2,38
70323761@N00,663,20,1305720396,1305724316,7,2,3920
70499124@N00,664,8,1333785962,1333785962,1,1,0
70929875@N00,665,8,1379052160,1379052160,1,2,0
70929875@N00,665,5,1379064208,1379064208,1,2,0
71039892@N00,666,12,1367822656,1367822656,1,1,0
71206023@N00,667,8,744130800,744130800,2,1,0
71206023@N00,668,8,1250835740,1250837072,5,1,1332
71311519@N00,669,8,1186376387,1186377113,4,1,726
71321381@N00,670,6,1274489633,1274490944,3,1,1311
71453924@N00,671,25,1239840220,1239840220,1,2,0
71453924@N00,671,6,1239842998,1239843007,2,2,9
71453924@N00,672,4,1239877147,1239878285,27,1,1138
71459982@N00,673,20,1253941652,1253941652,1,3,0
71459982@N00,673,7,1253937676,1253937676,1,3,0
71459982@N00,673,21,1253921816,1253921816,1,3,0
71459982@N00,674,21,1256181000,1256181000,1,1,0
71459982@N00,675,20,1259331653,1259331653,1,1,0
71459982@N00,676,20,1260368941,1260374220,2,1,5279
71459982@N00,677,21,1266988682,1266988682,1,1,0
71589712@N00,678,21,1149153943,1149154020,2,1,77
7183194@N02,679,20,1381574881,1381574881,1,1,0
7183194@N02,680,8,1381630754,1381631059,2,1,305
7183194@N02,681,3,1381731563,1381734383,2,6,2820
7183194@N02,681,20,1381716478,1381716478,1,6,0
7183194@N02,681,24,1381720171,1381720171,1,6,0
7183194@N02,681,15,1381735216,1381738037,4,6,2821
7183194@N02,681,22,1381730254,1381730808,2,6,554
7183194@N02,681,10,1381733939,1381733972,2,6,33
7183730@N06,682,8,1270095356,1270096188,4,1,832
7192664@N07,683,21,1203229981,1203229981,1,1,0
7192664@N07,684,15,1217656501,1217657718,7,2,1217
7192664@N07,684,16,1217652057,1217653015,10,2,958
7192664@N07,685,20,1361082180,1361082180,1,1,0
7192664@N07,686,28,1374920025,1374920045,2,1,20
72396314@N00,687,6,1144934019,1144934019,1,2,0
72396314@N00,687,5,1144924543,1144924543,1,2,0
72396314@N00,688,5,1264134053,1264134053,1,1,0
72537299@N00,689,4,1366871211,1366871211,1,1,0
72537299@N00,690,20,1366932525,1366932525,1,2,0
72537299@N00,690,8,1366937843,1366943879,3,2,6036
72537299@N00,691,1,1367054181,1367054181,1,2,0
72537299@N00,691,2,1367032340,1367032340,1,2,0
72537299@N00,692,20,1367152055,1367152055,1,1,0
7287903@N08,693,24,1244039217,1244040789,2,2,1572
7287903@N08,693,21,1244039840,1244039840,1,2,0
7287903@N08,694,11,1244071868,1244072774,3,1,906
73003003@N07,695,22,1343905658,1343905666,2,1,8
73024804@N00,696,20,1113059542,1113059542,1,1,0
73479994@N00,697,28,1249742711,1249743016,3,2,305
73479994@N00,697,20,1249718171,1249719317,2,2,1146
73488908@N00,698,18,1382982068,1382996322,3,1,14254
7380590@N03,699,5,1388232221,1388232221,1,1,0
7422166@N06,700,24,1363810547,1363810547,1,1,0
74223826@N00,701,24,1249385825,1249388122,3,1,2297
74527865@N00,702,8,1381726176,1381726443,3,1,267
74527865@N00,703,8,1382156781,1382156784,2,1,3
74828704@N00,704,1,1381784445,1381784445,1,2,0
74828704@N00,704,4,1381800984,1381800984,1,2,0
74888386@N00,705,20,1189880764,1189880764,1,1,0
74888386@N00,706,20,1189988430,1189995718,3,1,7288
74888386@N00,707,20,1190058015,1190074538,5,1,16523
75309441@N02,708,7,1368872353,1368872353,1,1,0
75595126@N00,709,5,1083659414,1083659414,1,1,0
75595126@N00,710,5,1146987478,1146987478,1,2,0
75595126@N00,710,22,1146961626,1146961626,1,2,0
75595126@N00,711,23,1147395064,1147395064,1,1,0
75595126@N00,712,6,1147683143,1147683143,1,1,0
75595126@N00,713,5,1173255823,1173255823,1,2,0
75595126@N00,713,22,1173265288,1173265432,2,2,144
75595126@N00,714,22,1173317668,1173317668,1,3,0
75595126@N00,714,18,1173311060,1173311060,1,3,0
75595126@N00,714,6,1173331760,1173331760,1,3,0
75595126@N00,715,22,1206075838,1206077638,2,1,1800
75595126@N00,716,5,1206173312,1206173312,1,1,0
75595126@N00,717,22,1206616443,1206616443,1,1,0
75834450@N00,718,20,1225974925,1225974925,1,2,0
75834450@N00,718,22,1225965996,1225965996,1,2,0
75834450@N00,719,2,1258079938,1258079938,1,1,0
75905404@N00,720,20,1366607738,1366622808,8,1,15070
75905404@N00,721,3,1366698740,1366702860,14,1,4120
7620454@N04,722,1,1274490112,1274490112,1,1,0
7620454@N04,723,6,1274530658,1274532524,3,1,1866
76236359@N00,724,4,1317614913,1317623426,4,2,8513
76236359@N00,724,1,1317609133,1317609309,2,2,176
76488173@N02,725,15,1325011066,1325011066,1,1,0
76488173@N02,726,8,1325061395,1325061395,1,1,0
76488173@N02,727,1,1356765797,1356765797,1,1,0
76758469@N00,728,5,1382238230,1382238230,1,2,0
76758469@N00,728,7,1382238859,1382245584,22,2,6725
77364115@N06,729,22,1335262162,1335262286,3,1,124
77526889@N00,730,20,1196917713,1196943037,4,5,25324
77526889@N00,730,1,1196930178,1196931411,6,5,1233
77526889@N00,730,11,1196919979,1196922450,4,5,2471
77526889@N00,730,6,1196946990,1196947475,6,5,485
77526889@N00,730,2,1196924986,1196928260,35,5,3274
77581941@N00,731,4,1230521482,1230534136,5,1,12654
77581941@N00,732,6,1230784823,1230796893,4,1,12070
77581941@N00,733,4,1231077971,1231077971,1,1,0
77684811@N00,734,24,1397641419,1397641419,1,1,0
77736600@N00,735,21,1156705147,1156705147,1,1,0
77736600@N00,736,8,1187348501,1187348501,1,1,0
77736600@N00,737,22,1223895451,1223895451,1,2,0
77736600@N00,737,23,1223894380,1223894380,1,2,0
77736600@N00,738,2,1237879064,1237879064,1,1,0
77736600@N00,739,1,1243487841,1243487841,1,1,0
77736600@N00,740,7,1249704782,1249704983,3,1,201
77947752@N07,741,8,1350890176,1350890176,1,1,0
78122393@N00,742,1,1345886473,1345886473,1,1,0
78122393@N00,743,1,1377940135,1377940135,1,1,0
78122393@N00,744,1,1379929576,1379929576,1,1,0
78122393@N00,745,1,1381879270,1381879270,1,1,0
78122393@N00,746,8,1396317415,1396317415,1,1,0
78530763@N03,747,6,1337550374,1337553556,6,1,3182
78530763@N03,748,12,1341009166,1341014141,12,1,4975
78530763@N03,749,7,1342411288,1342411580,3,1,292
78530763@N03,750,1,1343472997,1343473231,3,2,234
78530763@N03,750,2,1343473659,1343474614,7,2,955
78530763@N03,751,5,1353111571,1353111571,1,1,0
78530763@N03,752,24,1357962304,1357962304,1,1,0
78530763@N03,753,28,1359809528,1359809528,1,1,0
78530763@N03,754,18,1361680465,1361680465,1,1,0
78530763@N03,755,20,1364011976,1364011976,1,1,0
78530763@N03,756,7,1368524236,1368524236,1,1,0
78530763@N03,757,6,1380958586,1380964279,3,1,5693
78530763@N03,758,24,1381556791,1381556791,1,1,0
78530763@N03,759,5,1390639888,1390639888,1,1,0
79877212@N00,760,20,1380657917,1380657917,1,1,0
79877212@N00,761,22,1380721595,1380721595,1,1,0
79958874@N00,762,5,1345035771,1345036812,3,1,1041
79961175@N00,763,6,1396595628,1396603214,6,1,7586
79961175@N00,764,8,1396661228,1396661300,2,1,72
80256513@N00,765,21,1368188983,1368190629,2,1,1646
8025698@N08,766,19,1255861798,1255861798,1,1,0
8025698@N08,767,20,1292724575,1292724575,1,2,0
8025698@N08,767,21,1292724228,1292724228,1,2,0
8025698@N08,768,6,1322818219,1322818233,2,1,14
80438038@N00,769,6,1281086627,1281086627,1,1,0
80438038@N00,770,2,1281143391,1281148112,8,2,4721
80438038@N00,770,1,1281146964,1281151718,15,2,4754
8086087@N08,771,28,1211663892,1211663892,1,1,0
8092568@N04,772,15,1326520129,1326520129,1,1,0
80958550@N00,773,10,1125638098,1125638122,2,1,24
80958550@N00,774,7,1156503421,1156503421,1,1,0
80958550@N00,775,4,1235272702,1235274320,19,1,1618
80958550@N00,776,2,1247975414,1247975962,4,2,548
80958550@N00,776,1,1247980082,1247983268,7,2,3186
80958550@N00,777,4,1256973023,1256973397,23,1,374
80958550@N00,778,8,1270355064,1270361422,24,1,6358
80958550@N00,779,2,1322371825,1322372550,12,2,725
80958550@N00,779,1,1322362937,1322366561,27,2,3624
80958550@N00,780,5,1353808678,1353811354,2,1,2676
80958550@N00,781,12,1354414331,1354415269,5,1,938
80958550@N00,782,1,1355625189,1355626798,23,1,1609
80958550@N00,783,8,1365910051,1365915742,32,1,5691
80958550@N00,784,7,1382754265,1382755427,46,1,1162
81211130@N00,785,28,1160684486,1160684486,1,1,0
81397230@N00,786,8,1270011317,1270011317,1,2,0
81397230@N00,786,6,1270030439,1270030439,1,2,0
81397230@N00,787,10,1271135033,1271135033,1,2,0
81397230@N00,787,15,1271133736,1271133949,2,2,213
81427778@N00,788,20,1336371641,1336371910,5,1,269
8142856@N05,789,6,1292669818,1292670128,3,1,310
81498457@N00,790,8,1317479493,1317487531,7,1,8038
81788993@N00,791,21,1311408793,1311408793,1,2,0
81788993@N00,791,8,1311382465,1311387924,27,2,5459
81943113@N00,792,8,1290175195,1290178455,8,1,3260
81943113@N00,793,10,1290259788,1290259888,2,2,100
81943113@N00,793,9,1290261562,1290261773,4,2,211
81943113@N00,794,1,1290388804,1290417669,13,1,28865
81943113@N00,795,6,1365822296,1365823584,6,1,1288
8203293@N03,796,8,1386476357,1386476932,4,1,575
82256568@N03,797,7,1148734306,1148734306,1,1,0
82256568@N03,798,8,1148794650,1148794650,1,1,0
82256568@N03,799,1,1148880021,1148895831,21,1,15810
82365211@N00,800,21,1311933782,1311933782,1,1,0
82414749@N00,801,6,1387425937,1387425944,2,3,7
82414749@N00,801,20,1387425154,1387425154,1,3,0
82414749@N00,801,5,1387405100,1387405184,2,3,84
82414749@N00,802,8,1387481654,1387481654,1,1,0
82815724@N00,803,5,1258775889,1258775889,1,1,0
82909078@N07,804,6,1339307806,1339324304,38,1,16498
82909078@N07,805,22,1347158070,1347178936,28,2,20866
82909078@N07,805,3,1347152700,1347174779,25,2,22079
82909078@N07,806,6,1362294338,1362296792,8,1,2454
82909078@N07,807,3,1385782494,1385790709,9,1,8215
8372469@N08,808,8,1351241707,1351241707,1,1,0
84077682@N00,809,6,1387966316,1387966316,1,1,0
84104729@N00,810,20,1335022823,1335023130,3,1,307
84275582@N03,811,1,1221797739,1221802725,2,1,4986
84275582@N03,812,6,1222052391,1222055986,3,1,3595
84326824@N00,813,21,1235035429,1235036429,3,1,1000
84636962@N00,814,4,1208565619,1208565619,1,1,0
84636962@N00,815,20,1208599794,1208599794,1,1,0
8509783@N03,816,6,1324553515,1324556286,2,1,2771
85169164@N00,817,20,1335660309,1335660309,1,2,0
85169164@N00,817,21,1335685379,1335685379,1,2,0
85248599@N00,818,22,1262416141,1262416141,1,1,0
85600292@N03,819,20,1351147679,1351147679,1,2,0
85600292@N03,819,22,1351140267,1351140267,1,2,0
85736811@N00,820,8,1157377066,1157377075,3,3,9
85736811@N00,820,21,1157377077,1157377077,1,3,0
85736811@N00,820,22,1157377053,1157377056,2,3,3
85803506@N05,821,8,1357353662,1357353662,1,1,0
87126425@N00,822,6,1154010705,1154012646,2,1,1941
87533642@N00,823,4,1393043202,1393043202,1,1,0
87807876@N00,824,28,1185087636,1185087636,1,1,0
87807876@N00,825,23,1185181811,1185185596,11,2,3785
87807876@N00,825,28,1185192839,1185192839,1,2,0
87807876@N00,826,28,1363583369,1363583369,1,3,0
87807876@N00,826,20,1363591330,1363601744,14,3,10414
87807876@N00,826,21,1363584918,1363588296,4,3,3378
87807876@N00,827,23,1363690959,1363691300,3,1,341
87807876@N00,828,20,1363778430,1363778615,2,1,185
87807876@N00,829,8,1363825467,1363834870,36,1,9403
87807876@N00,830,28,1363866436,1363866537,3,1,101
87807876@N00,831,20,1363946944,1363946944,1,1,0
87807876@N00,832,22,1364091025,1364096553,5,2,5528
87807876@N00,832,23,1364098608,1364099888,6,2,1280
87807876@N00,833,28,1364169599,1364169599,1,1,0
87807876@N00,834,21,1364388238,1364388298,5,1,60
87807876@N00,835,20,1367153868,1367154214,5,1,346
87807876@N00,836,15,1367222921,1367224413,17,5,1492
87807876@N00,836,3,1367225565,1367225577,2,5,12
87807876@N00,836,20,1367191474,1367214840,39,5,23366
87807876@N00,836,22,1367225323,1367233935,37,5,8612
87807876@N00,836,21,1367204023,1367207296,8,5,3273
87807876@N00,837,5,1367282585,1367282661,2,1,76
87807876@N00,838,20,1367327606,1367327727,3,1,121
87807876@N00,839,20,1367368395,1367368546,2,1,151
87838077@N00,840,4,1219553361,1219579673,9,1,26312
87838077@N00,841,6,1243938558,1243938558,1,1,0
87838077@N00,842,1,1249545351,1249545351,1,1,0
88016824@N00,843,1,1215767986,1215772098,2,3,4112
88016824@N00,843,2,1215767646,1215769288,2,3,1642
88016824@N00,843,8,1215753344,1215761194,4,3,7850
8852942@N08,844,20,1312302126,1312302126,1,1,0
8852942@N08,845,21,1374989098,1374989296,2,1,198
8891828@N05,846,22,1373712528,1373712763,2,1,235
89096947@N00,847,5,1268278738,1268278738,1,1,0
8909846@N06,848,21,1380543431,1380543431,1,3,0
8909846@N06,848,20,1380536158,1380536158,1,3,0
8909846@N06,848,6,1380526055,1380526831,6,3,776
8909846@N06,849,21,1380666739,1380666739,1,1,0
8909846@N06,850,21,1380719051,1380719051,1,1,0
8909846@N06,851,21,1380756246,1380756246,2,1,0
8909846@N06,852,21,1380878178,1380890798,2,2,12620
8909846@N06,852,20,1380886413,1380886413,1,2,0
8909846@N06,853,21,1380931225,1380931225,1,1,0
8909846@N06,854,21,1381066471,1381066471,1,1,0
89188494@N00,855,16,1357277833,1357279678,9,1,1845
89965849@N00,856,22,1361720227,1361720227,1,1,0
9036889@N06,857,4,1372215532,1372234330,22,1,18798
9036889@N06,858,19,1372318522,1372318528,2,1,6
90412721@N00,859,21,1195434917,1195434962,3,2,45
90412721@N00,859,20,1195433530,1195447434,9,2,13904
90664717@N00,860,21,1384449446,1384449476,3,1,30
91041933@N00,861,8,1225113885,1225113885,1,1,0
91041933@N00,862,16,1225152971,1225152971,1,1,0
91041933@N00,863,16,1225235091,1225237125,2,1,2034
91041933@N00,864,6,1225323575,1225323606,2,2,31
91041933@N00,864,5,1225323642,1225327290,3,2,3648
91041933@N00,865,6,1225383893,1225383933,2,1,40
91041933@N00,866,6,1225552851,1225552860,2,1,9
91041933@N00,867,6,1225644164,1225644164,1,3,0
91041933@N00,867,5,1225643729,1225643735,2,3,6
91041933@N00,867,16,1225643170,1225672711,2,3,29541
91041933@N00,868,23,1226020425,1226020425,1,1,0
91041933@N00,869,6,1228624898,1228624973,3,1,75
91041933@N00,870,24,1290427529,1290427529,1,1,0
91041933@N00,871,24,1291904487,1291904546,2,1,59
91077297@N08,872,20,1297051867,1297051867,1,1,0
91077297@N08,873,9,1346377873,1346377873,1,1,0
91077297@N08,874,5,1374291852,1374291852,1,1,0
91273672@N02,875,5,1235903575,1235907892,14,1,4317
91273672@N02,876,4,1308186906,1308206881,7,1,19975
91462563@N00,877,25,1349492714,1349494744,17,2,2030
91462563@N00,877,5,1349496754,1349497170,11,2,416
91609485@N00,878,1,1376277491,1376283471,174,3,5980
91609485@N00,878,28,1376302547,1376302547,1,3,0
91609485@N00,878,2,1376284367,1376284367,1,3,0
92100908@N05,879,8,1242960897,1242960897,1,1,0
9252705@N03,880,8,1272855893,1272867621,18,1,11728
92636246@N00,881,8,1379474729,1379483213,26,1,8484
92636246@N00,882,21,1379653790,1379653790,1,1,0
92961234@N00,883,8,1230966964,1230966964,1,1,0
92982109@N00,884,5,1256012396,1256012642,3,1,246
9330653@N02,885,20,1270181471,1270187469,7,2,5998
9330653@N02,885,8,1270201859,1270202566,3,2,707
9341853@N08,886,8,1375243357,1375243357,1,1,0
9357526@N06,887,21,1292736694,1292736694,1,2,0
9357526@N06,887,1,1292723583,1292723583,1,2,0
94361609@N04,888,6,1098086206,1098086206,1,1,0
94387617@N00,889,25,1225473346,1225473346,1,1,0
94387617@N00,890,25,1234788283,1234788283,1,1,0
94387617@N00,891,25,1245419382,1245419382,1,1,0
94387617@N00,892,25,1247154350,1247154350,1,1,0
94387617@N00,893,5,1247485409,1247485409,1,1,0
94387617@N00,894,5,1247549423,1247549423,1,1,0
94387617@N00,895,21,1251202779,1251209310,3,1,6531
94387617@N00,896,5,1251394742,1251394742,1,1,0
94387617@N00,897,25,1253202176,1253202176,1,1,0
94387617@N00,898,3,1255160066,1255160066,1,1,0
94387617@N00,899,21,1261395754,1261399777,7,3,4023
94387617@N00,899,28,1261395147,1261395441,4,3,294
94387617@N00,899,5,1261371590,1261373528,16,3,1938
94387617@N00,900,6,1262003675,1262003675,1,1,0
94387617@N00,901,5,1267249520,1267249520,1,1,0
94387617@N00,902,4,1268464141,1268464141,1,1,0
94387617@N00,903,4,1270472344,1270472344,1,1,0
94387617@N00,904,21,1275358201,1275358201,1,1,0
94387617@N00,905,20,1279427187,1279437903,21,1,10716
94387617@N00,906,20,1279941885,1279941917,2,2,32
94387617@N00,906,21,1279943967,1279944485,3,2,518
94387617@N00,907,3,1289105171,1289112379,4,2,7208
94387617@N00,907,10,1289093665,1289093665,1,2,0
94387617@N00,908,5,1289540597,1289540597,1,1,0
94387617@N00,909,25,1294328182,1294328182,1,1,0
94387617@N00,910,5,1319520871,1319520871,1,1,0
94387617@N00,911,5,1319622783,1319622783,1,2,0
94387617@N00,911,28,1319638285,1319638285,1,2,0
94387617@N00,912,21,1322532351,1322547899,2,1,15548
94387617@N00,913,6,1322901818,1322907503,4,1,5685
94387617@N00,914,5,1323062238,1323062238,1,1,0
94387617@N00,915,25,1323525538,1323528623,5,1,3085
94387617@N00,916,21,1323564633,1323567444,2,1,2811
94387617@N00,917,5,1324359013,1324359013,1,1,0
94387617@N00,918,25,1325066276,1325066276,1,1,0
94387617@N00,919,25,1325253520,1325253520,1,1,0
94387617@N00,920,5,1325738806,1325738806,1,1,0
94387617@N00,921,5,1325825333,1325825333,1,1,0
94387617@N00,922,5,1328157484,1328157484,1,1,0
94387617@N00,923,5,1331876486,1331876486,1,1,0
94387617@N00,924,21,1332059926,1332059926,1,1,0
94387617@N00,925,5,1332133956,1332133956,1,1,0
94387617@N00,926,5,1332824072,1332824072,1,1,0
94387617@N00,927,5,1334283620,1334283620,1,1,0
94387617@N00,928,25,1338478016,1338478016,1,1,0
94387617@N00,929,25,1339091311,1339091311,1,1,0
94387617@N00,930,5,1340941435,1340941435,1,1,0
94387617@N00,931,5,1341895084,1341895084,1,1,0
94387617@N00,932,5,1342928217,1342928217,1,1,0
94387617@N00,933,25,1345462611,1345462611,1,1,0
94387617@N00,934,5,1348311493,1348311493,1,1,0
94387617@N00,935,5,1350035250,1350051473,80,1,16223
94387617@N00,936,10,1351997727,1351997727,1,2,0
94387617@N00,936,22,1352003596,1352004777,2,2,1181
94387617@N00,937,6,1356697968,1356697968,1,1,0
94387617@N00,938,11,1356756629,1356756629,1,1,0
94387617@N00,939,5,1358308318,1358308318,1,1,0
94387617@N00,940,21,1360475091,1360479345,2,3,4254
94387617@N00,940,23,1360487211,1360487211,1,3,0
94387617@N00,940,20,1360488683,1360488707,2,3,24
94387617@N00,941,5,1370320425,1370320425,1,1,0
94387617@N00,942,5,1370578589,1370578589,1,1,0
94387617@N00,943,28,1373343176,1373343176,1,1,0
94387617@N00,944,5,1373516009,1373516009,1,1,0
94387617@N00,945,25,1378480107,1378480107,1,1,0
94387617@N00,946,5,1378641354,1378642473,2,1,1119
94387617@N00,947,19,1380330903,1380330908,2,1,5
94387617@N00,948,21,1380371224,1380371425,2,2,201
94387617@N00,948,24,1380372290,1380372301,3,2,11
95157838@N00,949,20,1287920140,1287921087,4,1,947
95157838@N00,950,22,1287983464,1287990226,37,3,6762
95157838@N00,950,6,1288004001,1288010652,44,3,6651
95157838@N00,950,5,1288012213,1288014146,8,3,1933
95157838@N00,951,15,1288053859,1288061245,41,3,7386
95157838@N00,951,10,1288062784,1288064831,14,3,2047
95157838@N00,951,8,1288072486,1288078028,35,3,5542
95157838@N00,952,2,1335001873,1335004006,10,3,2133
95157838@N00,952,20,1334987601,1334987601,1,3,0
95157838@N00,952,22,1334992647,1334998566,28,3,5919
95157838@N00,953,8,1335072179,1335079136,17,2,6957
95157838@N00,953,6,1335090105,1335095883,16,2,5778
95157838@N00,954,21,1335145957,1335155160,21,2,9203
95157838@N00,954,24,1335147769,1335147776,2,2,7
95157838@N00,955,23,1335248999,1335248999,1,2,0
95157838@N00,955,20,1335229246,1335229296,4,2,50
95387115@N03,956,8,1380781495,1380781592,2,2,97
95387115@N03,956,6,1380800931,1380802284,4,2,1353
9574497@N07,957,8,1315544253,1315544253,1,1,0
96301288@N00,958,1,1223344987,1223349092,16,1,4105
96301288@N00,959,20,1223803763,1223803763,1,1,0
9643030@N08,960,5,1380852292,1380852292,1,4,0
9643030@N08,960,8,1380856855,1380856855,1,4,0
9643030@N08,960,15,1380863710,1380863710,1,4,0
9643030@N08,960,22,1380868205,1380870570,2,4,2365
96552229@N07,961,8,1372475212,1372475212,1,2,0
96552229@N07,961,20,1372494142,1372494142,1,2,0
96811126@N00,962,6,1336171627,1336172934,3,1,1307
97768382@N00,963,5,1007379316,1007379330,3,1,14
97898435@N00,964,8,1349017200,1349017200,8,2,0
97898435@N00,964,22,1349017200,1349017200,1,2,0
97898435@N00,965,20,1350638903,1350638903,1,1,0
97898435@N00,966,8,1350694496,1350696688,3,1,2192
97972855@N00,967,6,1287306823,1287307901,9,4,1078
97972855@N00,967,22,1287298037,1287302321,3,4,4284
97972855@N00,967,15,1287292692,1287295901,14,4,3209
97972855@N00,967,8,1287267607,1287280120,16,4,12513
97972855@N00,968,24,1287367789,1287369209,7,2,1420
97972855@N00,968,18,1287358337,1287358720,6,2,383
97972855@N00,969,1,1287444912,1287451490,18,2,6578
97972855@N00,969,2,1287444217,1287444531,4,2,314
97972855@N00,970,1,1287601264,1287611074,9,1,9810
97972855@N00,971,6,1345203797,1345204762,3,1,965
98153629@N00,972,24,1270295454,1270296954,6,2,1500
98153629@N00,972,20,1270298564,1270298564,1,2,0
9829009@N03,973,6,1269461464,1269461464,1,1,0
98533355@N00,974,2,1349546713,1349546713,1,1,0
98533355@N00,975,8,1349896609,1349896609,1,1,0
98601772@N00,976,7,1367831567,1367836162,7,1,4595
98827484@N00,977,20,1384858786,1384858786,1,1,0
98827484@N00,978,20,1385019321,1385028860,5,1,9539
99002017@N00,979,8,1395455175,1395455969,6,2,794
99002017@N00,979,7,1395452858,1395452858,1,2,0
99002017@N00,980,22,1395579339,1395579349,3,2,10
99002017@N00,980,29,1395577166,1395577166,1,2,0
99708700@N00,981,4,1392879305,1392879305,1,1,0
