userID,trajID,poiID,startTime,endTime,#photo,trajLen,poiDuration
10063645@N00,1,11,1160719626,1160719626,1,1,0
10063645@N00,2,2,1162254208,1162254208,1,1,0
10063645@N00,3,11,1162340788,1162340788,1,1,0
10063645@N00,4,16,1162700795,1162700795,1,2,0
10063645@N00,4,21,1162701017,1162701029,2,2,12
10063645@N00,5,15,1163143520,1163143520,1,2,0
10063645@N00,5,20,1163145517,1163145805,6,2,288
10063645@N00,6,11,1164183565,1164183565,1,1,0
10063645@N00,7,10,1164347993,1164348917,14,1,924
10063645@N00,8,15,1165557979,1165557979,1,1,0
10063645@N00,9,15,1166834553,1166834553,1,1,0
10063645@N00,10,11,1168141915,1168141915,1,1,0
10063645@N00,11,11,1168850110,1168850148,3,1,38
10063645@N00,12,15,1169186157,1169187468,6,1,1311
10251761@N04,13,24,1210153376,1210156841,10,1,3465
10259636@N05,14,21,1317439371,1317439371,1,1,0
10259636@N05,15,21,1317789827,1317789827,1,1,0
10259636@N05,16,16,1319243890,1319243890,1,1,0
10259636@N05,17,2,1321928618,1321928618,1,1,0
10259636@N05,18,21,1325908444,1325908444,1,1,0
10259636@N05,19,21,1335951724,1335951724,1,1,0
10259636@N05,20,2,1338767091,1338767091,1,1,0
10259636@N05,21,2,1342871983,1342871983,1,1,0
10338784@N02,22,16,1307797658,1307797658,1,1,0
10338784@N02,23,12,1308362901,1308362901,1,2,0
10338784@N02,23,16,1308362912,1308362912,1,2,0
10354154@N05,24,14,1284093935,1284093935,1,2,0
10354154@N05,24,20,1284091633,1284097563,3,2,5930
10354154@N05,25,20,1284699782,1284699782,1,1,0
10354154@N05,26,1,1346577776,1346594931,24,1,17155
10354154@N05,27,2,1381455994,1381456804,6,1,810
10354154@N05,28,1,1381573191,1381589621,4,2,16430
10354154@N05,28,16,1381567447,1381573041,7,2,5594
10354154@N05,29,2,1381645931,1381645965,2,1,34
10434252@N00,30,11,1342343605,1342343605,1,1,0
10482493@N05,31,20,1381996183,1382011673,3,4,15490
10482493@N05,31,2,1382010890,1382010890,1,4,0
10482493@N05,31,21,1382005643,1382007227,3,4,1584
10482493@N05,31,16,1381996941,1381997717,3,4,776
10486919@N00,32,16,1334697808,1334697808,1,1,0
10589348@N00,33,16,1365821219,1365821219,1,2,0
10589348@N00,33,1,1365821322,1365822018,5,2,696
10749810@N04,34,21,1247128033,1247132224,12,1,4191
10749810@N04,35,21,1250079016,1250093539,2,1,14523
10749810@N04,36,12,1278426908,1278427452,4,1,544
10749810@N04,37,12,1278518036,1278518168,9,1,132
11037560@N04,38,2,1308379702,1308379773,2,3,71
11037560@N04,38,13,1308365305,1308369996,5,3,4691
11037560@N04,38,21,1308373274,1308373274,1,3,0
11037560@N04,39,16,1308465767,1308465767,1,3,0
11037560@N04,39,2,1308458175,1308465217,2,3,7042
11037560@N04,39,21,1308465669,1308465669,1,3,0
11037560@N04,40,21,1315460681,1315460703,2,1,22
11037560@N04,41,21,1337849328,1337849328,1,2,0
11037560@N04,41,2,1337847287,1337847427,2,2,140
11037560@N04,42,1,1339475067,1339475204,4,1,137
11037560@N04,43,21,1355467431,1355467474,2,2,43
11037560@N04,43,2,1355467633,1355467997,5,2,364
11037560@N04,44,1,1370325413,1370325501,2,1,88
11154928@N04,45,6,1256291553,1256298042,10,1,6489
11154928@N04,46,6,1256473603,1256473771,2,1,168
11154928@N04,47,26,1379395836,1379396000,3,1,164
112042056@N06,48,10,1389668860,1389668868,2,1,8
112042056@N06,49,10,1389847825,1389860518,23,4,12693
112042056@N06,49,26,1389861832,1389863605,55,4,1773
112042056@N06,49,21,1389860107,1389860127,2,4,20
112042056@N06,49,2,1389833009,1389833009,1,4,0
113536856@N07,50,1,1171059148,1171059148,1,1,0
11452054@N00,51,19,1109344822,1109344822,1,1,0
11452054@N00,52,10,1109682993,1109682993,1,1,0
11452054@N00,53,19,1149534920,1149534920,1,1,0
11452054@N00,54,19,1155697520,1155697520,1,1,0
11452054@N00,55,28,1158987020,1158987020,1,3,0
11452054@N00,55,2,1158987430,1158987430,1,3,0
11452054@N00,55,13,1158987819,1158989526,9,3,1707
11452054@N00,56,26,1160363565,1160366056,7,2,2491
11452054@N00,56,1,1160358657,1160358657,1,2,0
11452054@N00,57,19,1172957726,1172957814,4,1,88
11452054@N00,58,26,1174254254,1174254334,3,1,80
11452054@N00,59,28,1271687266,1271687266,1,1,0
11452054@N00,60,2,1313576794,1313578279,9,1,1485
11452054@N00,61,9,1358055544,1358055544,1,2,0
11452054@N00,61,10,1358055661,1358055668,2,2,7
11452054@N00,62,7,1358417775,1358417775,1,1,0
11452054@N00,63,19,1377185006,1377185006,1,1,0
11452054@N00,64,12,1396950083,1396950083,1,1,0
11493297@N06,65,25,1276422419,1276422568,2,1,149
11493297@N06,66,25,1276485048,1276500089,2,2,15041
11493297@N06,66,10,1276477051,1276477051,1,2,0
11493297@N06,67,29,1276652487,1276652487,1,1,0
115792155@N07,68,2,1385823600,1385823600,4,1,0
11779319@N07,69,2,1350204992,1350204992,1,1,0
118442207@N03,70,20,1366434603,1366434603,1,1,0
11863277@N00,71,2,1314593977,1314593977,1,1,0
120428168@N03,72,12,1391253647,1391259551,16,1,5904
12067951@N00,73,7,1176712874,1176712874,1,1,0
12113931@N03,74,1,1331037331,1331037371,4,1,40
12113931@N03,75,1,1350302776,1350303451,23,1,675
12176100@N00,76,2,1123480101,1123480101,1,1,0
12364630@N00,77,1,1239503808,1239503872,2,1,64
12463089@N04,78,12,1355279486,1355279486,1,1,0
12463089@N04,79,16,1368095871,1368095871,1,1,0
12491204@N00,80,1,1204592901,1204593228,4,1,327
12491204@N00,81,15,1212123167,1212123167,1,1,0
12814307@N00,82,7,1207367565,1207367595,3,1,30
12832867@N03,83,1,1201268370,1201282428,16,1,14058
12914838@N00,84,26,1174196573,1174208887,5,1,12314
12914838@N00,85,15,1252573164,1252573164,1,1,0
12914838@N00,86,12,1253973837,1253973837,1,1,0
12914838@N00,87,11,1254451601,1254451863,2,1,262
12914838@N00,88,11,1254530803,1254530803,1,1,0
12914838@N00,89,19,1254562875,1254562875,1,1,0
12982579@N00,90,20,1347790948,1347790987,2,5,39
12982579@N00,90,11,1347764788,1347793571,4,5,28783
12982579@N00,90,25,1347782320,1347782515,4,5,195
12982579@N00,90,28,1347793220,1347793220,1,5,0
12982579@N00,90,26,1347771779,1347782080,26,5,10301
13286453@N00,91,16,1329805707,1329805707,1,1,0
13286453@N00,92,21,1371295331,1371295331,1,2,0
13286453@N00,92,16,1371296194,1371296239,2,2,45
13292225@N00,93,16,1279960956,1279960956,1,2,0
13292225@N00,93,2,1279959833,1279961263,4,2,1430
13447325@N07,94,2,1276302359,1276313418,3,1,11059
13523064@N03,95,10,1305538244,1305538244,1,1,0
13632620@N00,96,20,1228523350,1228523350,1,1,0
13808905@N02,97,28,1191079439,1191080768,27,1,1329
14023865@N06,98,29,1238639624,1238639624,1,1,0
14023865@N06,99,16,1361602096,1361602096,1,1,0
14041179@N00,100,28,1290335330,1290335330,1,1,0
14057878@N00,101,13,1195994901,1195995502,8,2,601
14057878@N00,101,7,1195993998,1195994036,2,2,38
14057878@N00,102,16,1235889117,1235891197,4,1,2080
14057878@N00,103,1,1247227672,1247232450,73,1,4778
14057878@N00,104,1,1292675197,1292679795,38,1,4598
14057878@N00,105,28,1318327895,1318337075,53,1,9180
14057878@N00,106,9,1351946901,1351954562,84,1,7661
14086506@N02,107,2,1247878361,1247878504,2,6,143
14086506@N02,107,21,1247890053,1247890053,1,6,0
14086506@N02,107,16,1247880806,1247882058,3,6,1252
14086506@N02,107,12,1247889132,1247889274,2,6,142
14086506@N02,107,14,1247893451,1247893517,2,6,66
14086506@N02,107,1,1247883009,1247885386,6,6,2377
14161458@N00,108,13,1149341644,1149341644,1,1,0
14161458@N00,109,13,1149509265,1149513256,10,1,3991
14332784@N05,110,15,1354946720,1354946720,1,1,0
14332784@N05,111,11,1354978282,1354987252,2,1,8970
14578360@N00,112,10,1113990024,1113990024,1,1,0
14578360@N00,113,9,1114766236,1114766236,1,1,0
14578360@N00,114,10,1115190673,1115190723,2,1,50
14578360@N00,115,1,1146484585,1146492253,19,1,7668
14578360@N00,116,1,1150028225,1150034388,15,1,6163
14578360@N00,117,26,1155540201,1155540592,2,2,391
14578360@N00,117,25,1155535289,1155535289,1,2,0
14578360@N00,118,1,1157545107,1157549086,15,1,3979
14578360@N00,119,10,1177991090,1177991090,1,3,0
14578360@N00,119,9,1177988734,1177990642,5,3,1908
14578360@N00,119,15,1177993043,1177996897,18,3,3854
14578360@N00,120,15,1190384963,1190402591,24,1,17628
14578360@N00,121,15,1197334821,1197334821,1,1,0
14578360@N00,122,15,1197650142,1197650142,1,2,0
14578360@N00,122,9,1197638457,1197646445,11,2,7988
14628725@N07,123,15,1214466673,1214466673,1,1,0
14628725@N07,124,15,1215082429,1215082429,1,1,0
14628725@N07,125,10,1215172760,1215172760,1,1,0
14628725@N07,126,15,1217077394,1217077394,1,1,0
14628725@N07,127,10,1219409316,1219409316,1,1,0
14628725@N07,128,15,1226200259,1226200259,1,1,0
14628725@N07,129,10,1229263547,1229263547,1,1,0
14628725@N07,130,15,1234101997,1234102935,5,1,938
14628725@N07,131,15,1237874041,1237874041,1,1,0
14628725@N07,132,10,1243517709,1243517709,1,2,0
14628725@N07,132,26,1243520903,1243520903,1,2,0
14628725@N07,133,25,1243754978,1243755536,3,1,558
14683455@N00,134,2,1250049648,1250049648,1,1,0
14683455@N00,135,2,1311824672,1311825889,80,1,1217
14761813@N00,136,1,1149049935,1149050175,2,1,240
14766679@N00,137,21,1136732773,1136733513,3,1,740
14779684@N08,138,29,1274620547,1274620547,1,1,0
14867874@N04,139,16,1214735825,1214741395,5,1,5570
14867874@N04,140,27,1237514187,1237515000,7,1,813
14929150@N08,141,8,1211928984,1211928984,1,1,0
15034392@N03,142,19,1255059976,1255059976,1,2,0
15034392@N03,142,11,1255050582,1255050582,1,2,0
15034392@N03,143,2,1255111682,1255111682,1,1,0
15058166@N06,144,13,1280475765,1280475765,1,1,0
15086444@N00,145,15,1315619975,1315619975,1,1,0
15111621@N05,146,20,1252052558,1252052558,1,2,0
15111621@N05,146,11,1252043757,1252043757,1,2,0
15209914@N04,147,26,1219054397,1219054397,1,1,0
15209914@N04,148,13,1264921056,1264921056,1,1,0
15209914@N04,149,13,1266408386,1266408386,1,1,0
15209914@N04,150,17,1274080778,1274080778,1,1,0
16069488@N00,151,1,1316550910,1316551363,3,1,453
16069488@N00,152,1,1316595619,1316595830,5,2,211
16069488@N00,152,29,1316592103,1316592103,1,2,0
16177445@N00,153,14,1192942532,1192942582,2,1,50
16312054@N06,154,16,1249893317,1249893666,14,5,349
16312054@N06,154,21,1249893760,1249894321,6,5,561
16312054@N06,154,20,1249889615,1249889615,1,5,0
16312054@N06,154,12,1249889035,1249889420,14,5,385
16312054@N06,154,1,1249894177,1249894709,8,5,532
16312054@N06,155,17,1250060312,1250063923,4,2,3611
16312054@N06,155,27,1250064549,1250066513,14,2,1964
16324044@N00,156,21,1178433687,1178438227,2,1,4540
16497759@N07,157,11,1331259666,1331259666,1,3,0
16497759@N07,157,28,1331260268,1331260268,1,3,0
16497759@N07,157,19,1331253935,1331253935,1,3,0
16497759@N07,158,22,1331341655,1331341655,1,2,0
16497759@N07,158,28,1331351202,1331354569,2,2,3367
16516058@N03,159,2,1348641046,1348641046,1,5,0
16516058@N03,159,16,1348620411,1348621701,3,5,1290
16516058@N03,159,21,1348640497,1348640497,1,5,0
16516058@N03,159,1,1348620083,1348620083,1,5,0
16516058@N03,159,12,1348617243,1348617758,4,5,515
16608296@N00,160,15,1282645719,1282645719,1,1,0
16608296@N00,161,2,1283130018,1283130132,3,1,114
16608296@N00,162,20,1334724844,1334724844,1,1,0
16608296@N00,163,15,1334817710,1334817710,1,1,0
16608296@N00,164,28,1335352011,1335352011,1,1,0
16608296@N00,165,15,1340861717,1340861717,1,1,0
16608296@N00,166,15,1341441620,1341441620,1,1,0
16608296@N00,167,9,1346299450,1346299450,1,1,0
16608296@N00,168,2,1346560546,1346560546,1,2,0
16608296@N00,168,12,1346562249,1346562249,1,2,0
16608296@N00,169,19,1346995011,1346995011,1,1,0
16608296@N00,170,16,1347064623,1347064623,1,1,0
16792567@N08,171,1,1379740483,1379740516,4,1,33
16806467@N08,172,22,1257420660,1257421673,63,1,1013
16857543@N07,173,15,1125500400,1125500400,23,1,0
16857543@N07,174,15,1148108565,1148109198,5,1,633
16857543@N07,175,15,1148140492,1148140492,1,1,0
17306001@N00,176,16,1334900048,1334900078,2,2,30
17306001@N00,176,21,1334900329,1334900329,1,2,0
17306001@N00,177,1,1359675487,1359675487,1,2,0
17306001@N00,177,16,1359676695,1359706207,14,2,29512
17358831@N00,178,16,1237459303,1237459303,1,3,0
17358831@N00,178,28,1237443911,1237443911,1,3,0
17358831@N00,178,11,1237444104,1237445421,4,3,1317
17424601@N00,179,21,1183265543,1183267596,3,3,2053
17424601@N00,179,1,1183258162,1183258162,1,3,0
17424601@N00,179,2,1183258316,1183258316,1,3,0
17486742@N00,180,21,1069317675,1069317727,2,1,52
17486742@N00,181,21,1125920498,1125920498,1,1,0
17486742@N00,182,16,1251941416,1251941416,1,1,0
17486742@N00,183,22,1319855508,1319856227,2,1,719
17643132@N00,184,16,1310166562,1310170677,6,4,4115
17643132@N00,184,2,1310165808,1310166105,9,4,297
17643132@N00,184,21,1310166349,1310166453,2,4,104
17643132@N00,184,13,1310154794,1310157275,49,4,2481
17774272@N00,185,13,1253144069,1253146380,19,1,2311
17774272@N00,186,11,1273965931,1273966261,10,2,330
17774272@N00,186,16,1273969298,1273969650,2,2,352
18284788@N00,187,16,1167302272,1167302272,1,2,0
18284788@N00,187,21,1167306336,1167318615,6,2,12279
18356888@N00,188,15,1114135050,1114135050,1,1,0
18356888@N00,189,15,1246521992,1246521992,1,1,0
18395063@N00,190,25,1374229248,1374229248,1,1,0
18502987@N00,191,16,1218249106,1218249106,1,1,0
18502987@N00,192,11,1281659237,1281659237,1,1,0
18502987@N00,193,22,1281752196,1281755578,3,1,3382
18502987@N00,194,22,1286973536,1286973670,5,1,134
18502987@N00,195,2,1327327278,1327327278,1,1,0
18502987@N00,196,28,1327815822,1327815822,1,1,0
18502987@N00,197,16,1332666765,1332666765,1,1,0
18502987@N00,198,28,1358549522,1358549522,1,1,0
18502987@N00,199,28,1358815078,1358815078,1,1,0
18502987@N00,200,28,1358850747,1358850747,1,1,0
18502987@N00,201,20,1360934697,1360934697,1,1,0
18502987@N00,202,28,1369700585,1369700587,2,2,2
18502987@N00,202,20,1369700567,1369700608,3,2,41
19368712@N00,203,10,1175436405,1175436405,1,1,0
19368712@N00,204,16,1210511049,1210511376,2,1,327
19368712@N00,205,1,1210955431,1210959059,3,2,3628
19368712@N00,205,10,1210948374,1210948374,1,2,0
19368712@N00,206,10,1211459459,1211462988,2,1,3529
19368712@N00,207,15,1211614324,1211614324,1,1,0
19368712@N00,208,15,1213504997,1213523654,5,1,18657
19368712@N00,209,1,1216393814,1216402130,6,1,8316
19368712@N00,210,16,1218887579,1218887579,1,1,0
19368712@N00,211,15,1222503055,1222503385,3,1,330
19368712@N00,212,20,1222584491,1222584672,2,1,181
19368712@N00,213,1,1227372769,1227379472,6,1,6703
19368712@N00,214,19,1229839569,1229839569,1,2,0
19368712@N00,214,2,1229848701,1229848701,1,2,0
19368712@N00,215,12,1231518549,1231523648,4,1,5099
19368712@N00,216,1,1231949778,1231949778,1,2,0
19368712@N00,216,15,1231944131,1231944507,3,2,376
19368712@N00,217,19,1234261193,1234261193,1,2,0
19368712@N00,217,13,1234246658,1234246954,3,2,296
19368712@N00,218,15,1234343688,1234343688,1,2,0
19368712@N00,218,10,1234335060,1234335148,2,2,88
19368712@N00,219,20,1234629181,1234629181,1,2,0
19368712@N00,219,2,1234629212,1234629212,1,2,0
19368712@N00,220,7,1239423072,1239423072,1,1,0
19368712@N00,221,12,1242486721,1242490639,2,1,3918
19368712@N00,222,2,1243656197,1243656197,1,1,0
19368712@N00,223,11,1244815089,1244815089,1,1,0
19368712@N00,224,10,1244866228,1244866228,1,1,0
19368712@N00,225,25,1246170181,1246172900,14,1,2719
19368712@N00,226,1,1250957531,1250957531,1,1,0
19368712@N00,227,12,1255794865,1255802164,5,1,7299
19368712@N00,228,1,1256478538,1256481745,5,1,3207
19368712@N00,229,10,1256543932,1256543932,1,1,0
19368712@N00,230,1,1256923233,1256923233,1,1,0
19368712@N00,231,11,1257443758,1257443758,1,1,0
19368712@N00,232,10,1258375221,1258375447,2,1,226
19368712@N00,233,1,1262278220,1262289790,15,1,11570
19414697@N00,234,20,1325561982,1325561982,1,1,0
19774989@N07,235,15,1199113200,1199113200,1,1,0
20344209@N00,236,2,1182290081,1182290356,2,2,275
20344209@N00,236,12,1182291171,1182291316,2,2,145
20416503@N00,237,19,1237535440,1237541629,7,1,6189
20483509@N00,238,9,1300606816,1300606816,1,3,0
20483509@N00,238,26,1300608115,1300608115,1,3,0
20483509@N00,238,2,1300611802,1300611802,1,3,0
20537795@N00,239,19,1342051185,1342051185,1,1,0
20537795@N00,240,16,1342130846,1342130846,1,1,0
20545573@N00,241,25,1240629095,1240629095,1,2,0
20545573@N00,241,26,1240628624,1240639118,22,2,10494
20545573@N00,242,16,1277031630,1277031630,1,1,0
20545573@N00,243,2,1285419384,1285419384,1,1,0
20793338@N07,244,20,1225604732,1225604732,1,1,0
20885015@N05,245,2,1283413891,1283413891,1,1,0
20901357@N05,246,21,1114873200,1114873200,1,1,0
20958272@N00,247,26,1239069428,1239071499,6,1,2071
21047061@N04,248,2,1176474123,1176474123,1,3,0
21047061@N04,248,16,1176458605,1176458605,1,3,0
21047061@N04,248,1,1176458596,1176458596,1,3,0
21116747@N02,249,2,1277488817,1277488906,3,2,89
21116747@N02,249,21,1277488570,1277488570,1,2,0
21116747@N02,250,2,1277647327,1277647327,1,1,0
21117297@N00,251,2,1282204326,1282219175,5,1,14849
21117297@N00,252,2,1282261013,1282261021,2,1,8
21117297@N00,253,21,1282449541,1282450348,4,2,807
21117297@N00,253,1,1282447099,1282447219,2,2,120
21117297@N00,254,16,1282482361,1282482361,1,1,0
21128947@N00,255,1,1333765453,1333765453,1,1,0
21245928@N00,256,13,1365231654,1365231654,1,1,0
21248348@N06,257,10,904575600,904575600,13,1,0
21248348@N06,258,10,978274800,978274800,4,1,0
21248348@N06,259,10,999270000,999270000,8,1,0
21248348@N06,260,10,1009810800,1009810800,7,1,0
21248348@N06,261,10,1012210521,1012210521,1,1,0
21248348@N06,262,10,1012489200,1012489200,27,1,0
21248348@N06,263,10,1013872299,1013872299,1,1,0
21248348@N06,264,10,1014191105,1014191105,1,1,0
21248348@N06,265,10,1033398000,1033398000,1,1,0
21248348@N06,266,10,1034242648,1034242648,1,1,0
21248348@N06,267,10,1034761050,1034761050,1,1,0
21248348@N06,268,10,1036076400,1036076400,1,1,0
21248348@N06,269,10,1041346800,1041346800,10,1,0
21248348@N06,270,15,1062342000,1062342000,6,1,0
21248348@N06,271,1,1066961122,1066961122,1,1,0
21248348@N06,272,1,1067004000,1067004052,52,1,52
21248348@N06,273,1,1076680800,1076680825,26,1,25
21248348@N06,274,1,1082728800,1082728874,75,1,74
21248348@N06,275,15,1095343200,1095343245,46,1,45
21248348@N06,276,10,1104505200,1104505200,1,1,0
21248348@N06,277,10,1105534997,1105534997,1,1,0
21248348@N06,278,1,1107525603,1107525665,63,1,62
21248348@N06,279,15,1116610633,1116610633,1,1,0
21248348@N06,280,1,1117807200,1117807225,26,1,25
21248348@N06,281,15,1118569286,1118569286,1,1,0
21248348@N06,282,15,1118843151,1118847519,40,1,4368
21248348@N06,283,10,1125500400,1125500400,1,1,0
21248348@N06,284,15,1126623398,1126628790,11,1,5392
21248348@N06,285,10,1126676338,1126677704,4,1,1366
21248348@N06,286,15,1126707750,1126719433,6,1,11683
21248348@N06,287,15,1126790576,1126804286,26,1,13710
21248348@N06,288,1,1129816800,1129816802,3,1,2
21248348@N06,289,10,1130770800,1130770800,3,1,0
21248348@N06,290,1,1133877600,1133877647,48,1,47
21248348@N06,291,10,1139324196,1139324708,8,1,512
21248348@N06,292,1,1139667940,1139683454,116,1,15514
21248348@N06,293,10,1139916305,1139921900,16,1,5595
21248348@N06,294,10,1141125297,1141129592,14,1,4295
21248348@N06,295,10,1141731262,1141734788,14,1,3526
21248348@N06,296,15,1165653324,1165653324,1,1,0
21248348@N06,297,10,1167577200,1167577200,1,1,0
21248348@N06,298,11,1170424800,1170424811,12,1,11
21248348@N06,299,11,1172774352,1172774352,1,1,0
21248348@N06,300,11,1172859106,1172866238,40,1,7132
21248348@N06,301,10,1187261805,1187261858,4,1,53
21248348@N06,302,10,1190397454,1190397488,3,1,34
21248348@N06,303,15,1213500378,1213523818,24,1,23440
21248348@N06,304,10,1222786800,1222786800,9,1,0
21248348@N06,305,11,1225459343,1225478230,39,1,18887
21248348@N06,306,11,1232546394,1232557257,25,1,10863
21248348@N06,307,11,1235138400,1235138404,9,1,4
21248348@N06,308,11,1243138920,1243138923,2,1,3
21248348@N06,309,10,1254899376,1254903713,8,1,4337
21248348@N06,310,10,1255857327,1255862305,40,1,4978
21248348@N06,311,11,1256997600,1257016595,124,1,18995
21248348@N06,312,10,1258095820,1258096134,2,1,314
21248348@N06,313,10,1258810496,1258812897,12,1,2401
21248348@N06,314,21,1259421483,1259431187,71,1,9704
21248348@N06,315,10,1264970022,1264970022,1,1,0
21248348@N06,316,1,1265142433,1265142433,1,1,0
21248348@N06,317,10,1265362090,1265364192,9,1,2102
21248348@N06,318,1,1265435510,1265435510,1,1,0
21248348@N06,319,1,1265608211,1265608211,1,1,0
21248348@N06,320,1,1267883090,1267898785,105,1,15695
21248348@N06,321,1,1268030479,1268030542,15,1,63
21248348@N06,322,10,1269501628,1269502212,5,1,584
21248348@N06,323,11,1276440916,1276450687,23,1,9771
21248348@N06,324,10,1283776681,1283776681,1,1,0
21248348@N06,325,9,1284430519,1284436900,8,2,6381
21248348@N06,325,10,1284431640,1284440565,6,2,8925
21248348@N06,326,10,1286295362,1286297392,16,1,2030
21248348@N06,327,11,1288263439,1288263439,1,1,0
21248348@N06,328,11,1288389732,1288465887,244,1,76155
21248348@N06,329,10,1289448345,1289454777,19,1,6432
21248348@N06,330,10,1290251497,1290255052,17,1,3555
21248348@N06,331,10,1295344308,1295345605,2,1,1297
21248348@N06,332,12,1295621178,1295635056,48,1,13878
21248348@N06,333,12,1295777788,1295777788,1,1,0
21248348@N06,334,1,1299132547,1299134415,4,1,1868
21248348@N06,335,1,1299309679,1299349522,153,1,39843
21248348@N06,336,10,1303754790,1303754790,1,1,0
21248348@N06,337,12,1312162150,1312162150,1,1,0
21283177@N00,338,19,1272332422,1272332422,1,1,0
21437097@N00,339,12,1280310921,1280310921,1,1,0
21439390@N00,340,21,1263435909,1263435909,1,1,0
21551510@N05,341,16,1303703016,1303703016,1,1,0
21551510@N05,342,12,1320398324,1320398324,1,1,0
21551510@N05,343,1,1325737825,1325737825,1,1,0
21551510@N05,344,11,1336185714,1336190343,2,1,4629
21551510@N05,345,2,1339735760,1339735760,1,2,0
21551510@N05,345,21,1339731535,1339731535,1,2,0
21551510@N05,346,21,1342154326,1342154396,2,1,70
21551510@N05,347,21,1342522623,1342522623,1,1,0
21551510@N05,348,1,1343270113,1343270113,1,1,0
21551510@N05,349,1,1343565288,1343565288,1,1,0
21551510@N05,350,21,1343636258,1343643292,3,1,7034
21551510@N05,351,1,1343717437,1343718331,2,1,894
21551510@N05,352,2,1343828037,1343828037,1,1,0
21551510@N05,353,1,1347235242,1347235242,1,1,0
21551510@N05,354,11,1349063760,1349064279,2,1,519
21551510@N05,355,15,1349685604,1349685604,1,1,0
21551510@N05,356,1,1353324242,1353324283,2,1,41
21551510@N05,357,11,1353494505,1353494505,1,1,0
21551510@N05,358,16,1355974256,1355974256,1,1,0
21551510@N05,359,16,1357789366,1357789366,1,1,0
21551510@N05,360,20,1358500801,1358500801,1,1,0
21551510@N05,361,25,1358910294,1358910294,1,1,0
21551510@N05,362,11,1361198400,1361198400,1,1,0
21551510@N05,363,26,1362220451,1362220451,1,1,0
21551510@N05,364,10,1362387469,1362387469,1,1,0
21551510@N05,365,6,1364715100,1364715100,1,1,0
21551510@N05,366,15,1366368602,1366368602,1,1,0
21551510@N05,367,22,1367278943,1367283535,3,1,4592
21551510@N05,368,1,1367639382,1367639382,1,1,0
21551510@N05,369,12,1377771190,1377771190,1,1,0
21551510@N05,370,21,1378891545,1378891545,1,1,0
21551510@N05,371,16,1379580248,1379580248,1,1,0
21551510@N05,372,19,1381201389,1381201389,1,1,0
21551510@N05,373,1,1382273317,1382273317,1,1,0
21551510@N05,374,21,1384418946,1384418946,1,1,0
21551510@N05,375,1,1384818462,1384818462,1,1,0
21551510@N05,376,1,1385340409,1385340409,1,1,0
21551510@N05,377,2,1386318144,1386318144,1,1,0
21551510@N05,378,16,1386733292,1386733292,1,1,0
21551510@N05,379,2,1390603815,1390603815,1,1,0
21551510@N05,380,19,1392784742,1392784742,1,1,0
21595257@N06,381,8,1353727326,1353738475,49,1,11149
21818828@N00,382,21,1353722382,1353722382,1,1,0
21818828@N00,383,1,1367942087,1367942087,1,1,0
21818828@N00,384,21,1390153359,1390153359,1,1,0
22017657@N05,385,16,1172674800,1172674800,214,1,0
22087304@N07,386,26,1222786800,1222786800,4,1,0
22087304@N07,387,10,1225465200,1225465200,3,4,0
22087304@N07,387,9,1225465200,1225465200,1,4,0
22087304@N07,387,21,1225465200,1225465200,10,4,0
22087304@N07,387,2,1225465200,1225465200,3,4,0
22087304@N07,388,25,1230735600,1230735600,1,1,0
22087304@N07,389,27,1238511600,1238511600,1,1,0
22087304@N07,390,26,1254322800,1254322800,1,1,0
22087304@N07,391,16,1257001200,1257001200,2,3,0
22087304@N07,391,26,1257001200,1257001200,4,3,0
22087304@N07,391,21,1257001200,1257001200,9,3,0
22087304@N07,392,26,1259383484,1259383484,1,1,0
22087304@N07,393,25,1259593200,1259593200,1,2,0
22087304@N07,393,26,1259593200,1259593200,2,2,0
22087304@N07,394,26,1260603510,1260603510,1,1,0
22087304@N07,395,26,1262271600,1262271600,1,2,0
22087304@N07,395,27,1262271600,1262271600,4,2,0
22087304@N07,396,22,1264950000,1264950000,8,2,0
22087304@N07,396,25,1264950000,1264950000,5,2,0
22087304@N07,397,26,1267369200,1267369200,1,1,0
22087304@N07,398,26,1270047600,1270047600,5,1,0
22087304@N07,399,10,1272639600,1272639600,1,2,0
22087304@N07,399,27,1272639600,1272639600,1,2,0
22087304@N07,400,11,1275318000,1275318000,2,1,0
22087304@N07,401,11,1276314217,1276314398,2,1,181
22087304@N07,402,27,1285858800,1285858800,3,3,0
22087304@N07,402,26,1285858800,1285858800,3,3,0
22087304@N07,402,17,1285858800,1285858800,1,3,0
22087304@N07,403,15,1291129200,1291129200,2,3,0
22087304@N07,403,26,1291129200,1291129200,5,3,0
22087304@N07,403,25,1291129200,1291129200,2,3,0
22087304@N07,404,10,1292138409,1292138409,1,1,0
22087304@N07,405,20,1293807600,1293807600,1,2,0
22087304@N07,405,2,1293807600,1293807600,57,2,0
22087304@N07,406,2,1296103748,1296113624,2,1,9876
22087304@N07,407,1,1304175600,1304175600,1,1,0
22087304@N07,408,21,1322665200,1322665200,2,1,0
22087304@N07,409,7,1325343600,1325343600,1,1,0
22087304@N07,410,7,1333206000,1333206000,1,1,0
22087304@N07,411,1,1356966000,1356966000,1,1,0
22087304@N07,412,11,1396340372,1396360240,7,1,19868
22087304@N07,413,11,1397385085,1397385085,1,1,0
22583315@N08,414,10,1370125548,1370125912,5,2,364
22583315@N08,414,15,1370122909,1370122909,1,2,0
22583315@N08,415,25,1370220766,1370220766,1,2,0
22583315@N08,415,26,1370220974,1370231713,2,2,10739
22583315@N08,416,28,1370318184,1370318393,3,1,209
22583315@N08,417,16,1371433545,1371439554,4,1,6009
22596839@N02,418,16,1382171242,1382171242,1,1,0
22686678@N05,419,21,1235035927,1235035927,1,2,0
22686678@N05,419,2,1235038094,1235038094,1,2,0
22751315@N05,420,2,1308464240,1308464240,1,3,0
22751315@N05,420,21,1308464130,1308464130,1,3,0
22751315@N05,420,1,1308464047,1308464047,1,3,0
22772546@N03,421,21,1296907420,1296907420,1,1,0
22772546@N03,422,1,1297525911,1297525911,1,2,0
22772546@N03,422,11,1297519838,1297519838,1,2,0
22772546@N03,423,12,1311104384,1311104384,1,1,0
22772546@N03,424,1,1334421328,1334421328,1,1,0
22772546@N03,425,28,1334754133,1334754133,1,1,0
22772546@N03,426,26,1338812854,1338812854,1,1,0
22772546@N03,427,2,1387525456,1387525456,1,1,0
23108377@N07,428,26,1365038355,1365038578,3,1,223
23108377@N07,429,11,1365194239,1365194239,1,1,0
23150784@N05,430,19,1264756686,1264756686,1,1,0
23150784@N05,431,26,1264839006,1264839770,2,1,764
23217533@N00,432,16,1100167756,1100167758,2,1,2
23217533@N00,433,16,1133853688,1133853696,2,1,8
23217533@N00,434,20,1135595461,1135595461,1,1,0
23217533@N00,435,1,1136977337,1136977337,2,1,0
23217533@N00,436,13,1138325774,1138325774,1,1,0
23217533@N00,437,13,1138942089,1138942089,1,1,0
23217533@N00,438,16,1150492234,1150493963,14,1,1729
23217533@N00,439,1,1166556119,1166556119,2,1,0
23217533@N00,440,25,1182118734,1182118734,1,1,0
23217533@N00,441,13,1199977529,1200004172,2,1,26643
23217533@N00,442,7,1201450061,1201450061,1,1,0
23217533@N00,443,13,1202775131,1202775131,1,1,0
23217533@N00,444,13,1204159051,1204159071,2,1,20
23217533@N00,445,13,1205720855,1205720855,1,1,0
23217533@N00,446,21,1220089241,1220089241,1,1,0
23217533@N00,447,1,1221315732,1221326364,5,1,10632
23217533@N00,448,26,1262495550,1262495550,1,1,0
23351536@N07,449,2,1266372822,1266372822,1,1,0
23351536@N07,450,10,1332816556,1332822212,4,1,5656
23351536@N07,451,10,1349664620,1349664679,2,1,59
23351536@N07,452,13,1394173961,1394175718,2,1,1757
23351536@N07,453,21,1394332615,1394332987,2,1,372
23363966@N02,454,28,1154052391,1154052391,1,2,0
23363966@N02,454,11,1154055296,1154055296,1,2,0
23363966@N02,455,2,1185448243,1185448243,1,3,0
23363966@N02,455,26,1185422980,1185422980,1,3,0
23363966@N02,455,19,1185430584,1185430584,1,3,0
23377996@N00,456,21,1270241876,1270241876,1,2,0
23377996@N00,456,16,1270242741,1270244189,3,2,1448
23401669@N00,457,26,1190602363,1190603190,5,1,827
23401669@N00,458,27,1203221215,1203221902,6,2,687
23401669@N00,458,17,1203212548,1203216755,13,2,4207
23401669@N00,459,19,1234494083,1234494083,1,1,0
23477028@N00,460,8,1213109929,1213109929,1,1,0
23522264@N05,461,26,1206325218,1206325218,1,1,0
23522264@N05,462,2,1228881541,1228881541,1,1,0
23522264@N05,463,13,1230695254,1230695254,1,1,0
23522264@N05,464,21,1230733030,1230735607,2,1,2577
23522264@N05,465,13,1231087012,1231087012,1,1,0
23522264@N05,466,1,1236835322,1236835601,2,1,279
23539578@N06,467,16,1252034857,1252035189,2,2,332
23539578@N06,467,1,1252035546,1252035546,1,2,0
23860276@N05,468,26,1288647235,1288647235,1,1,0
24077318@N03,469,2,1284777857,1284777857,1,1,0
24077318@N03,470,2,1284849424,1284849424,1,1,0
24095354@N00,471,2,1330622769,1330622769,1,1,0
24095354@N00,472,20,1331449103,1331449103,1,1,0
24095354@N00,473,20,1336085086,1336085086,1,1,0
24232779@N00,474,28,1252892271,1252923174,12,1,30903
24232779@N00,475,21,1252987015,1252988228,10,2,1213
24232779@N00,475,1,1252983375,1252983375,1,2,0
24452817@N04,476,2,1342248182,1342271752,5,1,23570
24469639@N00,477,1,1266055024,1266055024,1,2,0
24469639@N00,477,12,1266055180,1266055374,3,2,194
24616128@N00,478,13,1351456105,1351476286,17,3,20181
24616128@N00,478,2,1351464369,1351467960,5,3,3591
24616128@N00,478,20,1351480965,1351480965,1,3,0
24780667@N08,479,2,1227330006,1227330006,1,2,0
24780667@N08,479,19,1227320628,1227320628,1,2,0
24975340@N04,480,21,1311311266,1311311266,1,1,0
25389244@N00,481,2,1000159073,1000167897,3,2,8824
25389244@N00,481,26,1000155863,1000156513,3,2,650
25396215@N00,482,16,1216345441,1216345441,1,1,0
25396215@N00,483,21,1216420269,1216420393,3,3,124
25396215@N00,483,2,1216420898,1216421007,2,3,109
25396215@N00,483,11,1216445192,1216452160,6,3,6968
25561968@N00,484,16,1186210000,1186210021,2,1,21
25561968@N00,485,12,1196854553,1196856820,2,1,2267
25561968@N00,486,12,1210765550,1210765550,1,1,0
25561968@N00,487,9,1244954381,1244957594,14,1,3213
25636549@N08,488,28,1269592588,1269592588,1,1,0
25661863@N00,489,1,1368772776,1368772776,1,1,0
25764928@N00,490,13,1175842761,1175842761,1,1,0
25859917@N00,491,21,1293686906,1293690220,11,1,3314
25929111@N00,492,2,1284337502,1284337507,2,1,5
26036520@N00,493,16,1271432620,1271432661,3,1,41
26036520@N00,494,15,1301643617,1301643617,1,1,0
26036520@N00,495,21,1365162293,1365162293,1,1,0
26152696@N04,496,19,1330349012,1330349012,1,1,0
26265986@N00,497,12,1361097857,1361097857,1,1,0
26929313@N02,498,7,1346409645,1346409738,2,1,93
27022957@N03,499,20,1216431915,1216431915,1,1,0
27022957@N03,500,26,1218349395,1218350269,2,1,874
27022957@N03,501,26,1220160915,1220162387,2,1,1472
27133930@N00,502,2,1215263416,1215263754,3,1,338
27133930@N00,503,2,1215311167,1215311167,1,1,0
27196261@N00,504,15,1303484401,1303484401,1,1,0
27412901@N04,505,10,1256973489,1256973494,2,1,5
27412901@N04,506,20,1273137634,1273148726,94,1,11092
27418987@N03,507,22,1215661381,1215665754,9,1,4373
27545846@N04,508,26,1295184822,1295184822,1,1,0
27793158@N00,509,28,1041397207,1041397207,1,1,0
27793158@N00,510,28,1041448446,1041448446,6,2,0
27793158@N00,510,2,1041457147,1041461268,4,2,4121
27793158@N00,511,28,1168506000,1168506000,1,1,0
27817416@N02,512,10,1337830217,1337830217,1,1,0
27817416@N02,513,21,1337865974,1337866957,2,1,983
27817416@N02,514,2,1337922240,1337922240,1,1,0
27817416@N02,515,21,1338243485,1338243485,1,1,0
27817416@N02,516,1,1340279158,1340279158,1,1,0
27817416@N02,517,16,1346923088,1346923088,1,2,0
27817416@N02,517,1,1346919171,1346919277,2,2,106
27817416@N02,518,1,1347074357,1347074357,1,2,0
27817416@N02,518,9,1347083794,1347083864,2,2,70
27817416@N02,519,15,1350376365,1350376365,1,1,0
27820982@N05,520,10,1222059561,1222059561,1,1,0
27820982@N05,521,2,1233310485,1233310485,1,1,0
27828336@N00,522,22,1162965031,1162968073,3,1,3042
27828336@N00,523,13,1187242263,1187242389,2,1,126
27828336@N00,524,29,1188801574,1188801681,3,1,107
27828336@N00,525,22,1225087593,1225087597,2,1,4
27828336@N00,526,22,1274588274,1274594468,6,1,6194
27828336@N00,527,13,1291188293,1291192551,5,1,4258
27828336@N00,528,21,1317270239,1317270239,1,1,0
27877710@N00,529,12,1203328778,1203328778,1,1,0
28121598@N03,530,1,863503599,863503599,1,1,0
28209254@N08,531,1,1209342026,1209342153,4,1,127
28209254@N08,532,11,1209449349,1209449349,1,1,0
28209254@N08,533,6,1210064825,1210064825,1,1,0
28209254@N08,534,6,1212754577,1212754577,1,1,0
28209254@N08,535,11,1212802483,1212802483,1,1,0
28209254@N08,536,6,1216083940,1216084024,5,1,84
28209254@N08,537,1,1219151864,1219151864,1,1,0
28370443@N08,538,13,1341545528,1341548443,14,8,2915
28370443@N08,538,28,1341550386,1341560068,6,8,9682
28370443@N08,538,11,1341557009,1341557187,3,8,178
28370443@N08,538,16,1341561385,1341561385,1,8,0
28370443@N08,538,2,1341544166,1341544452,7,8,286
28370443@N08,538,7,1341545136,1341545136,1,8,0
28370443@N08,538,21,1341543290,1341543290,1,8,0
28370443@N08,538,12,1341561338,1341561338,1,8,0
28479267@N00,539,12,1281354221,1281358811,18,1,4590
28528680@N00,540,16,1253445444,1253445444,1,1,0
28528680@N00,541,20,1352957951,1352957951,1,1,0
28528680@N00,542,20,1358858057,1358858177,2,1,120
28528680@N00,543,20,1359461970,1359461970,1,1,0
28528680@N00,544,20,1359893384,1359893384,1,1,0
28683534@N00,545,13,1345338827,1345338827,1,1,0
28946048@N00,546,16,1195836319,1195836319,1,1,0
28946048@N00,547,16,1197047285,1197047285,1,1,0
28946048@N00,548,16,1198249650,1198258589,9,1,8939
28946048@N00,549,16,1198857785,1198857800,2,1,15
28946048@N00,550,16,1203694124,1203699691,2,1,5567
28946048@N00,551,20,1276267142,1276267142,1,1,0
28946048@N00,552,2,1281935901,1281935901,1,1,0
29032147@N03,553,26,1376716230,1376716230,1,1,0
29357851@N00,554,15,1283939858,1283939858,1,1,0
29365083@N06,555,1,1321253079,1321253079,1,1,0
29365083@N06,556,1,1354408089,1354408089,1,1,0
29365083@N06,557,2,1355726578,1355726578,1,2,0
29365083@N06,557,21,1355727338,1355727338,1,2,0
29365083@N06,558,7,1357263058,1357263058,1,1,0
29365083@N06,559,7,1357716039,1357716039,1,1,0
29365083@N06,560,2,1360817669,1360817669,1,1,0
29365083@N06,561,9,1362715132,1362715132,1,1,0
29365083@N06,562,13,1364882189,1364884821,7,1,2632
29365083@N06,563,1,1372669231,1372669231,1,1,0
29365083@N06,564,21,1384848890,1384848890,1,1,0
29486666@N00,565,26,1309494900,1309494900,1,1,0
29685744@N05,566,20,1339134348,1339134933,3,1,585
29685744@N05,567,20,1339499770,1339499770,1,1,0
29712408@N02,568,2,1234274397,1234274397,1,1,0
29712408@N02,569,1,1288615818,1288615818,1,1,0
29712408@N02,570,29,1289291217,1289291217,1,1,0
29712408@N02,571,10,1289451624,1289451624,1,1,0
29712408@N02,572,29,1289816175,1289816175,1,1,0
29712408@N02,573,29,1291122753,1291122753,1,1,0
29712408@N02,574,6,1295506498,1295506498,1,1,0
29797746@N08,575,1,1364168207,1364197135,6,7,28928
29797746@N08,575,12,1364196627,1364196712,4,7,85
29797746@N08,575,25,1364187127,1364187131,2,7,4
29797746@N08,575,11,1364172135,1364196062,15,7,23927
29797746@N08,575,28,1364190537,1364196263,5,7,5726
29797746@N08,575,26,1364174141,1364186765,22,7,12624
29797746@N08,575,29,1364190171,1364190171,1,7,0
29797746@N08,576,28,1364359687,1364359900,7,2,213
29797746@N08,576,12,1364356005,1364359567,7,2,3562
29797746@N08,577,16,1364455278,1364455432,5,2,154
29797746@N08,577,1,1364455513,1364456771,7,2,1258
29797746@N08,578,16,1364522315,1364522549,4,2,234
29797746@N08,578,2,1364522655,1364523057,4,2,402
29797746@N08,579,16,1364560218,1364560218,1,1,0
29825849@N00,580,20,1315024164,1315024164,1,1,0
29825849@N00,581,1,1316242207,1316242207,1,1,0
29909815@N00,582,11,1104505200,1104505200,1,1,0
29909815@N00,583,13,1179712088,1179712239,2,1,151
29909815@N00,584,13,1179749078,1179753735,4,1,4657
30007308@N00,585,26,1321838829,1321842224,3,2,3395
30007308@N00,585,25,1321842075,1321842546,2,2,471
30007308@N00,586,17,1321926591,1321926591,1,1,0
30024546@N04,587,12,1222161756,1222161976,2,3,220
30024546@N04,587,25,1222152323,1222152474,2,3,151
30024546@N04,587,10,1222153376,1222153376,1,3,0
30024546@N04,588,11,1223439830,1223439830,1,1,0
30024546@N04,589,6,1224992301,1224992301,1,1,0
30024546@N04,590,9,1225342907,1225342907,1,1,0
30024546@N04,591,12,1225600746,1225600746,1,1,0
30024546@N04,592,15,1226452234,1226452234,1,1,0
30024546@N04,593,15,1226991763,1226991763,1,1,0
30024546@N04,594,15,1227249204,1227249955,2,1,751
30024546@N04,595,28,1232075177,1232075177,1,1,0
30024546@N04,596,15,1235627233,1235627233,1,1,0
30024546@N04,597,15,1250736973,1250736973,1,1,0
30024546@N04,598,15,1259394622,1259395037,2,1,415
30024546@N04,599,9,1260147523,1260147523,1,1,0
30024546@N04,600,28,1262589846,1262589865,3,1,19
30024546@N04,601,6,1263868857,1263868857,1,1,0
30024546@N04,602,2,1263980755,1263980755,1,1,0
30024546@N04,603,28,1264570611,1264570611,1,1,0
30024546@N04,604,28,1265341135,1265341625,4,2,490
30024546@N04,604,11,1265342032,1265342363,3,2,331
30024546@N04,605,10,1265692019,1265692019,1,1,0
30024546@N04,606,28,1265770277,1265772379,2,2,2102
30024546@N04,606,11,1265769629,1265769629,1,2,0
30024546@N04,607,10,1267504652,1267504652,1,1,0
30024546@N04,608,11,1268017438,1268017551,3,1,113
30024546@N04,609,9,1268618709,1268618709,1,1,0
30024546@N04,610,12,1269482990,1269483368,3,1,378
30024546@N04,611,16,1270254869,1270254869,1,1,0
30024546@N04,612,15,1272240737,1272240737,1,1,0
30024546@N04,613,10,1272500240,1272500780,6,1,540
30024546@N04,614,10,1272616856,1272616856,1,1,0
30024546@N04,615,9,1273018416,1273018416,1,1,0
30024546@N04,616,15,1273635393,1273635939,3,1,546
30024546@N04,617,9,1275443602,1275443602,1,1,0
30024546@N04,618,11,1279872004,1279872004,1,1,0
30024546@N04,619,28,1279935764,1279935764,1,2,0
30024546@N04,619,11,1279935990,1279935990,1,2,0
30024546@N04,620,11,1280810646,1280810646,1,1,0
30024546@N04,621,12,1284532614,1284532659,2,1,45
30024546@N04,622,28,1285383751,1285385064,2,1,1313
30024546@N04,623,28,1285750157,1285750157,1,1,0
30024546@N04,624,15,1287971416,1287971416,1,1,0
30024546@N04,625,12,1288580313,1288580313,1,1,0
30024546@N04,626,26,1288941004,1288941004,1,1,0
30024546@N04,627,11,1292047718,1292048026,2,1,308
30024546@N04,628,28,1293155742,1293155742,1,2,0
30024546@N04,628,11,1293154371,1293154641,3,2,270
30024546@N04,629,29,1294453559,1294453559,1,2,0
30024546@N04,629,12,1294455521,1294455692,3,2,171
30024546@N04,630,11,1295855047,1295855047,1,2,0
30024546@N04,630,20,1295854471,1295854471,1,2,0
30024546@N04,631,10,1296004106,1296004580,2,1,474
30024546@N04,632,12,1296094652,1296094652,1,1,0
30024546@N04,633,12,1297140585,1297145259,47,1,4674
30024546@N04,634,12,1297226865,1297226865,1,1,0
30024546@N04,635,10,1297904573,1297904573,1,1,0
30024546@N04,636,29,1298944320,1298944320,1,1,0
30024546@N04,637,15,1309591849,1309591849,1,1,0
30024546@N04,638,12,1315055205,1315055205,1,1,0
30024546@N04,639,9,1315978732,1315978732,1,1,0
30024546@N04,640,28,1323156875,1323156875,1,1,0
30024546@N04,641,10,1323410778,1323410778,1,1,0
30024546@N04,642,10,1337589672,1337589672,1,1,0
30024546@N04,643,26,1337843728,1337843728,1,3,0
30024546@N04,643,11,1337822473,1337822473,1,3,0
30024546@N04,643,12,1337823973,1337824624,4,3,651
30024546@N04,644,26,1337999618,1338001160,3,1,1542
30024546@N04,645,26,1338047422,1338047422,1,1,0
30024546@N04,646,15,1338177522,1338178405,3,1,883
30024546@N04,647,10,1338267442,1338267474,2,1,32
30024546@N04,648,10,1338525055,1338525055,1,2,0
30024546@N04,648,13,1338531336,1338531336,1,2,0
30024546@N04,649,28,1340327450,1340333289,30,1,5839
30024546@N04,650,28,1340511819,1340517732,2,1,5913
30024546@N04,651,1,1340586923,1340587571,3,1,648
30024546@N04,652,28,1340669507,1340674742,30,1,5235
30024546@N04,653,28,1340846146,1340852052,33,1,5906
30024546@N04,654,21,1341205084,1341205084,1,1,0
30024546@N04,655,1,1346724295,1346724295,1,1,0
30024546@N04,656,2,1349751294,1349751436,3,2,142
30024546@N04,656,28,1349749594,1349749594,1,2,0
30024546@N04,657,7,1352168792,1352168792,1,1,0
30024546@N04,658,7,1352268865,1352268865,1,1,0
30024546@N04,659,15,1353396910,1353396910,1,1,0
30024546@N04,660,9,1353589790,1353589790,1,1,0
30024546@N04,661,11,1354855768,1354855768,1,1,0
30024546@N04,662,12,1359181136,1359181235,2,1,99
30024546@N04,663,28,1359339156,1359339609,3,1,453
30024546@N04,664,28,1359408741,1359408741,1,1,0
30024546@N04,665,12,1360294810,1360294810,1,3,0
30024546@N04,665,20,1360296538,1360296621,3,3,83
30024546@N04,665,28,1360294168,1360294168,1,3,0
30024546@N04,666,9,1361522299,1361522299,1,1,0
30024546@N04,667,9,1362459324,1362459324,1,2,0
30024546@N04,667,10,1362458668,1362461858,2,2,3190
30024546@N04,668,15,1363146623,1363146623,1,1,0
30024546@N04,669,11,1363230629,1363230629,1,1,0
30024546@N04,670,12,1363672870,1363673338,7,3,468
30024546@N04,670,2,1363672446,1363672446,1,3,0
30024546@N04,670,20,1363671601,1363673427,9,3,1826
30024546@N04,671,26,1365132316,1365133767,6,1,1451
30024546@N04,672,29,1366606258,1366606258,1,2,0
30024546@N04,672,11,1366609225,1366609225,1,2,0
30024546@N04,673,11,1367640897,1367640897,1,1,0
30024546@N04,674,26,1367731511,1367731511,1,1,0
30024546@N04,675,26,1367833792,1367833792,1,1,0
30024546@N04,676,11,1371867357,1371867357,1,1,0
30047476@N05,677,21,1359261156,1359261156,1,2,0
30047476@N05,677,2,1359260748,1359260748,1,2,0
30194693@N00,678,16,1221364426,1221368109,6,2,3683
30194693@N00,678,21,1221368610,1221370070,7,2,1460
30296805@N00,679,10,1227766738,1227766788,2,1,50
30511496@N00,680,13,1145845431,1145845438,2,3,7
30511496@N00,680,11,1145845445,1145845467,4,3,22
30511496@N00,680,2,1145845425,1145845474,2,3,49
30671962@N05,681,21,1232096398,1232096398,1,2,0
30671962@N05,681,2,1232095624,1232095624,1,2,0
30671962@N05,682,21,1248588570,1248588570,1,3,0
30671962@N05,682,2,1248601046,1248601515,2,3,469
30671962@N05,682,5,1248597161,1248597161,1,3,0
30697354@N00,683,15,1126834375,1126857995,21,1,23620
30713600@N00,684,1,1277180536,1277181139,5,3,603
30713600@N00,684,2,1277178288,1277178419,3,3,131
30713600@N00,684,16,1277179535,1277180424,3,3,889
30942843@N00,685,19,1175860192,1175873024,2,1,12832
30942843@N00,686,15,1181455898,1181457267,12,1,1369
30942843@N00,687,20,1191232568,1191233202,3,1,634
30942843@N00,688,21,1191843041,1191843041,1,2,0
30942843@N00,688,2,1191842569,1191842868,3,2,299
30942843@N00,689,2,1194259329,1194259480,4,1,151
30942843@N00,690,2,1209465731,1209465731,1,1,0
30942843@N00,691,13,1270794999,1270794999,1,1,0
30963564@N00,692,20,1348197285,1348197285,1,1,0
30963564@N00,693,20,1348235267,1348235267,1,1,0
30963564@N00,694,20,1348272284,1348272284,1,1,0
30969398@N05,695,10,1259212765,1259212765,1,1,0
30985799@N00,696,2,1246337315,1246337315,1,1,0
30985799@N00,697,20,1246600745,1246600745,1,3,0
30985799@N00,697,26,1246590242,1246596004,13,3,5762
30985799@N00,697,2,1246589566,1246600762,2,3,11196
30985799@N00,698,2,1249963947,1249963947,1,1,0
30985799@N00,699,20,1252292102,1252292102,1,1,0
30985799@N00,700,16,1272533094,1272533094,1,1,0
30985799@N00,701,28,1280487514,1280487514,1,2,0
30985799@N00,701,20,1280478597,1280478597,1,2,0
30985799@N00,702,6,1280572672,1280572672,1,1,0
30985799@N00,703,26,1285212507,1285219551,2,1,7044
30985799@N00,704,12,1350466661,1350466661,1,1,0
31191687@N06,705,26,1222826690,1222827900,2,1,1210
31191687@N06,706,16,1227420976,1227421157,2,2,181
31191687@N06,706,21,1227420786,1227420900,2,2,114
31191687@N06,707,21,1239261195,1239261195,1,1,0
31191687@N06,708,26,1244961771,1244961822,2,1,51
31191687@N06,709,26,1269157343,1269159976,3,1,2633
31191687@N06,710,21,1276350230,1276353353,2,1,3123
31191687@N06,711,28,1290273744,1290278420,4,2,4676
31191687@N06,711,21,1290260662,1290260662,1,2,0
31191687@N06,712,16,1291086393,1291086393,1,1,0
31191687@N06,713,16,1294472199,1294472199,1,1,0
31191687@N06,714,28,1295103304,1295103576,2,1,272
31191687@N06,715,16,1297248264,1297248264,1,1,0
31191687@N06,716,28,1302949117,1302949117,1,2,0
31191687@N06,716,1,1302938953,1302938953,1,2,0
31191687@N06,717,1,1306827541,1306827556,2,1,15
31191687@N06,718,21,1314506109,1314506327,2,1,218
31191687@N06,719,18,1335674909,1335674909,1,1,0
31191687@N06,720,2,1345870411,1345870411,1,1,0
31191687@N06,721,18,1352284882,1352284882,1,1,0
31191687@N06,722,18,1354703875,1354703875,1,1,0
31191687@N06,723,16,1371084485,1371084485,1,1,0
31191687@N06,724,18,1380624102,1380624102,1,1,0
31226953@N00,725,15,1200370788,1200380449,3,1,9661
31438571@N07,726,22,1297453273,1297453413,3,1,140
31438571@N07,727,22,1310023851,1310023851,1,1,0
31438571@N07,728,11,1319182167,1319182167,1,1,0
31438571@N07,729,18,1331782936,1331784895,4,1,1959
31438571@N07,730,11,1332909624,1332909624,1,1,0
31438571@N07,731,11,1332990097,1332990102,2,1,5
31438571@N07,732,2,1335586848,1335586848,1,3,0
31438571@N07,732,21,1335586052,1335586052,1,3,0
31438571@N07,732,16,1335588446,1335588659,11,3,213
31438571@N07,733,11,1336178601,1336191581,6,1,12980
31438571@N07,734,11,1336977843,1336977843,1,1,0
31438571@N07,735,11,1337847038,1337851493,4,1,4455
31438571@N07,736,11,1339142971,1339144323,13,2,1352
31438571@N07,736,2,1339151665,1339153582,2,2,1917
31438571@N07,737,2,1342835021,1342838650,29,1,3629
31438571@N07,738,20,1343187088,1343187178,4,1,90
31438571@N07,739,11,1356161503,1356161503,1,1,0
31438571@N07,740,21,1360907200,1360907200,1,1,0
31438571@N07,741,10,1361971983,1361971983,1,1,0
31438571@N07,742,21,1362464391,1362464834,8,1,443
31438571@N07,743,1,1363230151,1363230151,1,1,0
31438571@N07,744,10,1363828460,1363828460,1,1,0
31438571@N07,745,21,1364562063,1364562063,1,2,0
31438571@N07,745,16,1364565600,1364565600,1,2,0
31438571@N07,746,21,1364623551,1364623551,1,1,0
31438571@N07,747,12,1364781040,1364781040,1,1,0
31438571@N07,748,1,1366182286,1366182286,1,1,0
31438571@N07,749,11,1367404402,1367404402,1,1,0
31438571@N07,750,11,1367557263,1367576726,4,1,19463
31438571@N07,751,11,1367634615,1367634615,1,1,0
31438571@N07,752,11,1367742736,1367742736,1,2,0
31438571@N07,752,21,1367752534,1367752534,1,2,0
31438571@N07,753,26,1368022107,1368022107,1,1,0
31438571@N07,754,11,1369130291,1369130291,1,1,0
31438571@N07,755,21,1369314706,1369314706,1,1,0
31438571@N07,756,11,1373427414,1373427752,2,1,338
31438571@N07,757,11,1374830091,1374830091,1,1,0
31438571@N07,758,16,1398392789,1398392789,1,1,0
31564588@N06,759,16,1227906020,1227906020,1,3,0
31564588@N06,759,21,1227905958,1227906226,7,3,268
31564588@N06,759,2,1227906257,1227906313,2,3,56
31620722@N05,760,14,1242810861,1242814805,3,1,3944
31803571@N02,761,13,1365819309,1365819309,1,3,0
31803571@N02,761,2,1365817979,1365817979,1,3,0
31803571@N02,761,22,1365823962,1365824542,7,3,580
31803571@N02,762,28,1365860638,1365860638,1,1,0
31917967@N00,763,21,1320903337,1320903337,1,1,0
32026981@N00,764,2,1234234776,1234244955,2,1,10179
32026981@N00,765,1,1249025433,1249028647,4,1,3214
32105612@N00,766,15,1231066012,1231066696,6,1,684
32397300@N04,767,20,1233885569,1233899734,14,1,14165
32397300@N04,768,16,1381299859,1381299901,2,1,42
32397300@N04,769,9,1382351394,1382351394,1,1,0
32399776@N00,770,2,1183132007,1183137073,2,1,5066
32399776@N00,771,16,1240760119,1240760119,1,1,0
32399776@N00,772,16,1303192119,1303192119,1,1,0
32399776@N00,773,12,1375688827,1375707007,5,1,18180
32426344@N00,774,13,1208870607,1208870654,2,1,47
32426344@N00,775,7,1279418525,1279418525,1,1,0
32426344@N00,776,11,1333366835,1333366835,1,1,0
32662153@N00,777,26,1093124722,1093124727,4,1,5
32693718@N07,778,1,833122800,833122800,1,1,0
32693718@N07,779,16,833209204,833209204,1,3,0
32693718@N07,779,1,833209201,833209202,2,3,1
32693718@N07,779,2,833209205,833209205,1,3,0
32714545@N05,780,16,1340513457,1340513897,2,3,440
32714545@N05,780,14,1340517053,1340517053,1,3,0
32714545@N05,780,13,1340527408,1340527408,1,3,0
32819190@N00,781,2,1120143619,1120143785,12,1,166
32819190@N00,782,21,1151772189,1151772189,1,2,0
32819190@N00,782,2,1151772191,1151772191,1,2,0
32819190@N00,783,2,1192693383,1192693838,2,1,455
32819190@N00,784,2,1195994134,1195994711,5,1,577
32819190@N00,785,21,1204958872,1204958872,1,1,0
32975851@N00,786,21,1387979046,1387979046,1,2,0
32975851@N00,786,16,1387977679,1387977679,1,2,0
33148051@N00,787,11,1228936618,1228936618,1,1,0
33162611@N06,788,2,1287985350,1287985350,1,1,0
33278177@N00,789,21,1252832886,1252832886,1,4,0
33278177@N00,789,16,1252833043,1252833043,1,4,0
33278177@N00,789,1,1252830526,1252830526,1,4,0
33278177@N00,789,6,1252835599,1252835599,1,4,0
33278177@N00,790,16,1252903440,1252903440,1,1,0
33333470@N00,791,19,1210245701,1210250110,16,1,4409
33333470@N00,792,28,1225437819,1225437819,1,1,0
33333470@N00,793,28,1227690035,1227690035,1,1,0
33333470@N00,794,19,1248501039,1248504541,6,1,3502
33563858@N00,795,28,1213601377,1213601377,1,3,0
33563858@N00,795,13,1213587905,1213592782,25,3,4877
33563858@N00,795,20,1213600937,1213600937,1,3,0
34085730@N06,796,20,1395383650,1395383650,1,1,0
34244919@N00,797,10,1270875536,1270875536,1,1,0
34268979@N05,798,2,1311723978,1311723978,1,1,0
34268979@N05,799,2,1313537752,1313537752,1,1,0
34268979@N05,800,21,1315784529,1315784529,1,1,0
34268979@N05,801,13,1340146311,1340146381,2,1,70
34268979@N05,802,9,1353746556,1353746556,1,2,0
34268979@N05,802,10,1353745249,1353745249,1,2,0
34268979@N05,803,20,1357601907,1357601907,1,1,0
34268979@N05,804,12,1357876524,1357876723,2,1,199
34268979@N05,805,21,1365720414,1365720414,1,1,0
34374129@N00,806,1,1183966813,1183966845,8,1,32
34374129@N00,807,16,1204797979,1204799503,16,1,1524
34374129@N00,808,1,1228486344,1228487945,4,1,1601
34374129@N00,809,16,1253181954,1253183071,7,1,1117
34374129@N00,810,1,1349910057,1349910057,1,1,0
34374129@N00,811,15,1357276064,1357277796,3,2,1732
34374129@N00,811,10,1357278033,1357278033,1,2,0
34374129@N00,812,1,1393828403,1393828403,1,1,0
34427470616@N01,813,28,1097526953,1097526953,1,3,0
34427470616@N01,813,16,1097526881,1097526881,1,3,0
34427470616@N01,813,1,1097526867,1097526867,1,3,0
34427470616@N01,814,1,1105839291,1105839326,4,4,35
34427470616@N01,814,9,1105842712,1105842712,1,4,0
34427470616@N01,814,20,1105839332,1105839332,1,4,0
34427470616@N01,814,28,1105839307,1105839307,1,4,0
34427470616@N01,815,28,1143767375,1143767375,1,1,0
34427470616@N01,816,15,1158302715,1158303001,2,1,286
34427470616@N01,817,21,1163839918,1163839918,1,1,0
34427470616@N01,818,15,1185601855,1185601855,1,1,0
34666709@N00,819,1,1373695304,1373695304,1,2,0
34666709@N00,819,21,1373660376,1373672423,2,2,12047
34746026@N03,820,12,1313836850,1313848532,13,1,11682
34894709@N00,821,20,1349717512,1349717512,1,1,0
34894709@N00,822,15,1350022979,1350022979,1,1,0
34947461@N00,823,15,1369403024,1369403024,1,1,0
34947461@N00,824,21,1369446076,1369446076,1,1,0
34947461@N00,825,21,1370165823,1370165823,1,1,0
34995267@N00,826,28,1178664533,1178664533,1,3,0
34995267@N00,826,12,1178665119,1178665119,1,3,0
34995267@N00,826,29,1178663517,1178663517,1,3,0
35034349172@N01,827,15,1252815337,1252815337,1,1,0
35034349172@N01,828,15,1253176719,1253176719,1,1,0
35034349172@N01,829,16,1267852764,1267852764,1,1,0
35034349172@N01,830,26,1269828033,1269828033,1,1,0
35034349172@N01,831,9,1274167615,1274167615,1,1,0
35034349172@N01,832,26,1274244748,1274244748,1,1,0
35034349172@N01,833,10,1274564382,1274564382,1,1,0
35034349172@N01,834,10,1274667893,1274667893,1,1,0
35034349172@N01,835,10,1275094949,1275094949,1,1,0
35034349172@N01,836,10,1275960460,1275960469,2,1,9
35034349172@N01,837,10,1276500259,1276500259,1,1,0
35034349172@N01,838,15,1276559110,1276559110,1,1,0
35034349172@N01,839,10,1276589199,1276589199,1,1,0
35034349172@N01,840,15,1277260317,1277268682,16,2,8365
35034349172@N01,840,10,1277261185,1277267436,23,2,6251
35034349172@N01,841,10,1277775423,1277775588,6,2,165
35034349172@N01,841,15,1277773079,1277775189,3,2,2110
35034349172@N01,842,10,1278635910,1278635943,2,2,33
35034349172@N01,842,15,1278635369,1278635369,1,2,0
35034349172@N01,843,10,1282882816,1282882816,1,1,0
35034349172@N01,844,15,1283072705,1283072705,1,1,0
35034349172@N01,845,15,1283150803,1283150803,1,1,0
35034349172@N01,846,10,1286851826,1286851826,1,1,0
35034349172@N01,847,9,1287879373,1287879373,1,2,0
35034349172@N01,847,26,1287879935,1287880076,3,2,141
35034349172@N01,848,15,1288061779,1288061802,2,1,23
35034349172@N01,849,10,1288315373,1288315373,1,1,0
35034349172@N01,850,10,1288856677,1288856684,2,2,7
35034349172@N01,850,15,1288874207,1288874207,1,2,0
35034349172@N01,851,15,1289953748,1289953748,1,1,0
35034349172@N01,852,15,1290078009,1290081381,4,1,3372
35034349172@N01,853,10,1291373493,1291373493,1,1,0
35034349172@N01,854,10,1291600022,1291600052,2,1,30
35034349172@N01,855,25,1292119685,1292119685,1,2,0
35034349172@N01,855,26,1292119653,1292119653,1,2,0
35034349172@N01,856,10,1292204745,1292204757,3,2,12
35034349172@N01,856,15,1292204597,1292204597,1,2,0
35034349172@N01,857,16,1294460795,1294460795,1,1,0
35034349172@N01,858,10,1295181420,1295181420,1,1,0
35034349172@N01,859,15,1299049456,1299049472,3,1,16
35034349172@N01,860,15,1300231788,1300231788,1,1,0
35034349172@N01,861,26,1300942334,1300943181,8,1,847
35034349172@N01,862,10,1302482135,1302482135,1,1,0
35034349172@N01,863,15,1304467417,1304467417,1,1,0
35034349172@N01,864,15,1305438113,1305438113,1,1,0
35034349172@N01,865,15,1305592899,1305592899,1,1,0
35034349172@N01,866,15,1306135995,1306136321,4,1,326
35034349172@N01,867,10,1306372313,1306372313,1,1,0
35034349172@N01,868,15,1306725168,1306725168,1,1,0
35034349172@N01,869,10,1307074582,1307074582,1,1,0
35034349172@N01,870,15,1307622060,1307622060,1,1,0
35034349172@N01,871,9,1308293082,1308296323,2,2,3241
35034349172@N01,871,10,1308296521,1308296521,1,2,0
35034349172@N01,872,10,1308643578,1308643578,1,1,0
35034349172@N01,873,10,1308719751,1308719751,1,1,0
35034349172@N01,874,15,1310616103,1310616103,1,1,0
35034349172@N01,875,26,1311481806,1311481806,1,1,0
35034349172@N01,876,10,1311813007,1311813038,3,1,31
35034349172@N01,877,15,1311843115,1311843118,2,1,3
35034349172@N01,878,15,1311993930,1311993930,1,1,0
35034349172@N01,879,17,1312601960,1312601967,2,2,7
35034349172@N01,879,27,1312595521,1312596822,28,2,1301
35034349172@N01,880,16,1313821678,1313823571,3,1,1893
35034349172@N01,881,15,1316079517,1316079517,1,1,0
35034349172@N01,882,10,1330573164,1330573164,1,1,0
35034349172@N01,883,15,1330940922,1330940980,2,1,58
35034349172@N01,884,10,1331179329,1331179329,1,1,0
35034349172@N01,885,10,1331256736,1331256736,1,1,0
35034349172@N01,886,10,1331621869,1331621869,1,2,0
35034349172@N01,886,15,1331599439,1331599439,1,2,0
35034349172@N01,887,26,1332040676,1332040690,2,1,14
35034349172@N01,888,10,1332988979,1332988979,1,1,0
35034349172@N01,889,15,1333170468,1333170495,2,1,27
35034349172@N01,890,15,1333253370,1333253370,1,1,0
35034349172@N01,891,15,1333612348,1333612550,4,1,202
35034349172@N01,892,15,1334015801,1334015801,1,1,0
35034349172@N01,893,10,1334118146,1334118146,1,1,0
35034349172@N01,894,15,1334364265,1334364265,1,1,0
35034349172@N01,895,26,1334449981,1334449981,1,1,0
35034349172@N01,896,15,1334978073,1334978073,1,2,0
35034349172@N01,896,26,1334979746,1334984764,6,2,5018
35034349172@N01,897,10,1335582355,1335582631,2,3,276
35034349172@N01,897,25,1335583589,1335591895,3,3,8306
35034349172@N01,897,26,1335583830,1335591273,3,3,7443
35034349172@N01,898,26,1375423977,1375430527,4,4,6550
35034349172@N01,898,10,1375417919,1375423122,3,4,5203
35034349172@N01,898,15,1375415025,1375415025,1,4,0
35034349172@N01,898,25,1375431030,1375431030,1,4,0
35034349172@N01,899,25,1375608526,1375608597,2,3,71
35034349172@N01,899,15,1375599538,1375599538,1,3,0
35034349172@N01,899,10,1375596788,1375596788,1,3,0
35034349172@N01,900,15,1375694646,1375704039,7,2,9393
35034349172@N01,900,16,1375686251,1375686251,1,2,0
35034349172@N01,901,28,1375771038,1375774004,2,1,2966
35034349972@N01,902,26,1118366506,1118366506,1,1,0
35034349972@N01,903,16,1121407211,1121407211,1,1,0
35034349972@N01,904,1,1121795115,1121795115,1,1,0
35034349972@N01,905,11,1136040954,1136040954,1,1,0
35034349972@N01,906,11,1155809373,1155809459,2,1,86
35034349972@N01,907,1,1157890186,1157890186,1,1,0
35126681@N07,908,2,1397270121,1397270121,1,1,0
35153835@N04,909,9,1233918391,1233931139,42,1,12748
35341699@N05,910,10,1155973706,1155973706,1,1,0
35468140287@N01,911,1,1230554918,1230554918,1,1,0
35468147887@N01,912,10,893948400,893948400,1,1,0
35468147887@N01,913,11,943974000,943974000,1,1,0
35468147887@N01,914,15,1236172398,1236172398,1,1,0
35468147887@N01,915,16,1238824120,1238824120,1,1,0
35468147887@N01,916,25,1254837844,1254837844,1,1,0
35468147887@N01,917,19,1256286118,1256286118,1,1,0
35468147887@N01,918,19,1258601406,1258601406,1,1,0
35468147887@N01,919,15,1258806582,1258806582,1,1,0
35468147887@N01,920,15,1261286671,1261301940,2,1,15269
35468147887@N01,921,19,1265357656,1265357656,1,1,0
35468152754@N01,922,21,1187399354,1187413858,3,4,14504
35468152754@N01,922,1,1187399844,1187399844,1,4,0
35468152754@N01,922,16,1187399586,1187399586,1,4,0
35468152754@N01,922,2,1187398464,1187398464,1,4,0
35468159247@N01,923,10,386434800,386434800,1,1,0
35468159247@N01,924,10,496940400,496940400,1,1,0
35468159247@N01,925,11,908769600,908769600,1,1,0
35468159247@N01,926,10,1071127423,1071127423,1,1,0
35468159247@N01,927,10,1085632869,1085633251,6,1,382
35468159247@N01,928,10,1093936200,1093936200,3,1,0
35468159247@N01,929,1,1139666471,1139680466,6,1,13995
35468159247@N01,930,15,1145887197,1145887197,1,1,0
35468159247@N01,931,1,1146195909,1146195909,1,1,0
35468159247@N01,932,28,1149315553,1149315553,1,1,0
35468159247@N01,933,26,1155364280,1155368113,5,1,3833
35468159247@N01,934,28,1159756268,1159756268,1,1,0
35468159247@N01,935,26,1165126376,1165128185,3,1,1809
35468159247@N01,936,11,1165238172,1165238631,2,1,459
35468159247@N01,937,20,1165290578,1165290578,1,1,0
35468159247@N01,938,1,1171931887,1171931887,1,1,0
35468159247@N01,939,26,1180336967,1180337711,2,1,744
35468159247@N01,940,1,1180436595,1180445477,2,1,8882
35468159247@N01,941,15,1184346322,1184346322,1,1,0
35468159247@N01,942,2,1188090248,1188090351,3,1,103
35468159247@N01,943,10,1190089279,1190089279,1,1,0
35468159247@N01,944,10,1190211200,1190236238,5,2,25038
35468159247@N01,944,16,1190183690,1190183690,1,2,0
35468159247@N01,945,10,1193573037,1193578779,12,1,5742
35468159247@N01,946,16,1195370432,1195370432,1,1,0
35468159247@N01,947,28,1195471810,1195471810,1,1,0
35468159247@N01,948,28,1195736908,1195736908,1,1,0
35468159247@N01,949,15,1196481676,1196481676,1,1,0
35468159247@N01,950,15,1196531108,1196531216,2,1,108
35468159247@N01,951,19,1196756078,1196756078,1,1,0
35468159247@N01,952,15,1203684665,1203699967,7,1,15302
35468159247@N01,953,15,1203905057,1203905200,3,1,143
35468159247@N01,954,11,1212223824,1212223824,1,1,0
35468159247@N01,955,26,1220077420,1220077420,1,2,0
35468159247@N01,955,25,1220080069,1220082831,6,2,2762
35468159247@N01,956,2,1230386054,1230386389,2,1,335
35468159247@N01,957,10,1238213345,1238213345,1,4,0
35468159247@N01,957,9,1238214632,1238214632,1,4,0
35468159247@N01,957,25,1238212826,1238212826,1,4,0
35468159247@N01,957,2,1238243380,1238243380,1,4,0
35468159247@N01,958,16,1261119805,1261119891,2,1,86
35468159247@N01,959,25,1261288254,1261288531,3,1,277
35468159247@N01,960,16,1261472149,1261472880,2,1,731
35468159247@N01,961,29,1267854424,1267854424,1,1,0
35468159247@N01,962,25,1271566804,1271566927,2,1,123
35468159247@N01,963,12,1276678098,1276678098,1,2,0
35468159247@N01,963,16,1276677993,1276677993,1,2,0
35468159247@N01,964,19,1302249698,1302249698,1,3,0
35468159247@N01,964,10,1302244700,1302244700,1,3,0
35468159247@N01,964,15,1302244182,1302244244,2,3,62
35468159247@N01,965,7,1302402781,1302406155,3,1,3374
35468159247@N01,966,1,1306722097,1306722097,1,1,0
35468159247@N01,967,25,1316852132,1316852213,2,1,81
35468159247@N01,968,20,1325131359,1325131359,1,1,0
35468159247@N01,969,2,1325306621,1325306621,1,2,0
35468159247@N01,969,21,1325305632,1325305632,1,2,0
35468159247@N01,970,27,1348814141,1348814141,1,1,0
35468159247@N01,971,16,1377759744,1377759744,1,1,0
35468159247@N01,972,2,1384926328,1384926503,2,1,175
35653526@N02,973,2,1247295600,1247295677,76,1,77
35667940@N00,974,1,1271220701,1271220701,1,2,0
35667940@N00,974,11,1271225488,1271225488,1,2,0
35761150@N04,975,16,1396673565,1396673586,3,7,21
35761150@N04,975,10,1396681005,1396683435,63,7,2430
35761150@N04,975,9,1396680536,1396680966,19,7,430
35761150@N04,975,1,1396673837,1396673870,3,7,33
35761150@N04,975,26,1396680130,1396680149,2,7,19
35761150@N04,975,21,1396673294,1396673467,2,7,173
35761150@N04,975,15,1396683678,1396683678,1,7,0
35761150@N04,976,2,1396768237,1396768403,5,3,166
35761150@N04,976,16,1396760563,1396771261,5,3,10698
35761150@N04,976,29,1396757606,1396757983,9,3,377
35891436@N03,977,20,1246778590,1246778590,1,1,0
36382844@N00,978,16,1287207566,1287207566,1,1,0
36382844@N00,979,28,1287286032,1287286032,1,1,0
36382844@N00,980,21,1287713085,1287713085,1,1,0
36382844@N00,981,1,1289447231,1289447231,1,1,0
36382844@N00,982,1,1289621799,1289621799,1,1,0
36382844@N00,983,28,1290318552,1290318552,1,1,0
36382844@N00,984,1,1290466239,1290466239,1,1,0
36382844@N00,985,1,1291005228,1291005228,1,1,0
36382844@N00,986,1,1291072448,1291072448,1,1,0
36382844@N00,987,21,1291114550,1291114550,1,1,0
36382844@N00,988,21,1291810039,1291810039,1,1,0
36382844@N00,989,16,1293171884,1293171884,1,1,0
36382844@N00,990,21,1294033493,1294033493,1,1,0
36382844@N00,991,1,1294181429,1294181429,1,1,0
36382844@N00,992,15,1298089667,1298089667,1,1,0
36382844@N00,993,1,1300230174,1300230174,1,1,0
36382844@N00,994,28,1300596313,1300596313,1,1,0
36382844@N00,995,15,1302323269,1302323269,1,1,0
36382844@N00,996,1,1307141240,1307141240,1,1,0
36382844@N00,997,20,1307777195,1307777195,1,1,0
36382844@N00,998,1,1309475689,1309475689,1,1,0
36382844@N00,999,1,1313761733,1313761733,1,1,0
36382844@N00,1000,16,1319193205,1319193205,1,1,0
36382844@N00,1001,12,1320034617,1320036389,2,1,1772
36382844@N00,1002,1,1320987168,1320987168,1,1,0
36382844@N00,1003,12,1322974560,1322974560,1,1,0
36382844@N00,1004,12,1333867183,1333867183,1,1,0
36462710@N03,1005,11,1305975760,1305976484,8,1,724
36521966221@N01,1006,16,1114997432,1114997432,1,1,0
36521966221@N01,1007,15,1118261406,1118261406,1,1,0
36521966221@N01,1008,21,1119760330,1119760330,1,1,0
36521966221@N01,1009,13,1121738953,1121738953,1,1,0
36521966221@N01,1010,25,1138346805,1138346805,1,1,0
36521966221@N01,1011,2,1165485966,1165487354,3,1,1388
36521966221@N01,1012,21,1177817938,1177818152,5,1,214
36521966221@N01,1013,13,1212119855,1212121100,3,1,1245
36521966221@N01,1014,22,1215661456,1215662102,2,1,646
36521966221@N01,1015,13,1215746413,1215746440,3,1,27
36521966221@N01,1016,2,1216094155,1216094155,1,1,0
36521966221@N01,1017,2,1219288102,1219288102,1,1,0
36521966221@N01,1018,2,1225682881,1225682881,1,1,0
36521966221@N01,1019,20,1225857250,1225857253,4,1,3
36521966221@N01,1020,6,1227238712,1227238726,3,1,14
36521966221@N01,1021,16,1228301983,1228301988,2,2,5
36521966221@N01,1021,19,1228302083,1228302083,1,2,0
36521966221@N01,1022,16,1262411575,1262411575,1,1,0
36521966221@N01,1023,13,1262753567,1262753890,37,1,323
36521966221@N01,1024,28,1268905099,1268905108,2,1,9
36521966221@N01,1025,12,1270185247,1270185247,1,1,0
36521966221@N01,1026,26,1270901602,1270901624,2,2,22
36521966221@N01,1026,25,1270901649,1270901881,13,2,232
36521966221@N01,1027,12,1271813840,1271814045,2,1,205
36521966221@N01,1028,1,1272179355,1272179355,1,1,0
36521966221@N01,1029,26,1272858606,1272858609,2,1,3
36521966221@N01,1030,1,1287725001,1287725001,1,1,0
36521966221@N01,1031,12,1292977173,1292977173,1,1,0
36521966221@N01,1032,12,1297209459,1297209459,1,1,0
36521966221@N01,1033,28,1299006054,1299006054,1,1,0
36521966221@N01,1034,14,1300996646,1300996646,1,1,0
36521966221@N01,1035,12,1301075584,1301075584,1,1,0
36521966221@N01,1036,29,1302203852,1302203852,1,1,0
36521966221@N01,1037,11,1307771032,1307771032,1,1,0
36521982700@N01,1038,16,1344339152,1344339152,1,1,0
36521982700@N01,1039,26,1344534361,1344534361,1,1,0
36539950@N00,1040,1,1350699103,1350699103,1,2,0
36539950@N00,1040,28,1350693294,1350694670,2,2,1376
36539950@N00,1041,2,1389771336,1389771336,1,1,0
36688133@N00,1042,2,1357274826,1357274876,2,1,50
36744244@N00,1043,25,1266304796,1266304796,1,1,0
36829918@N00,1044,2,1378373336,1378373579,3,2,243
36829918@N00,1044,21,1378376678,1378376678,1,2,0
36829918@N00,1045,25,1378715383,1378715954,16,2,571
36829918@N00,1045,26,1378716500,1378716827,10,2,327
36829918@N00,1046,2,1379408467,1379408467,1,1,0
36928267@N06,1047,6,1298465645,1298466633,2,1,988
36928267@N06,1048,15,1306034319,1306034319,1,1,0
36928267@N06,1049,1,1310817343,1310817343,1,1,0
36928267@N06,1050,1,1314445140,1314446576,2,1,1436
36928267@N06,1051,28,1315639779,1315642940,2,1,3161
36928267@N06,1052,14,1318492621,1318492621,1,1,0
36928267@N06,1053,1,1335346945,1335346945,1,1,0
36928267@N06,1054,16,1335597637,1335598111,2,1,474
36928267@N06,1055,10,1335680870,1335680870,1,1,0
36928267@N06,1056,28,1339574041,1339574041,1,1,0
36928267@N06,1057,11,1340361107,1340364378,2,1,3271
36928267@N06,1058,10,1344144816,1344145337,3,1,521
36928267@N06,1059,21,1362394102,1362397182,2,1,3080
36928267@N06,1060,21,1369127939,1369134188,5,1,6249
36928267@N06,1061,28,1370745064,1370746700,2,1,1636
36928267@N06,1062,28,1373077416,1373085522,7,1,8106
36928267@N06,1063,21,1376723420,1376723420,1,1,0
36928267@N06,1064,19,1387541010,1387545606,3,1,4596
36967808@N00,1065,26,1361440730,1361440730,1,1,0
37138982@N08,1066,26,1258537065,1258537318,3,1,253
37138982@N08,1067,10,1259164606,1259166787,9,1,2181
37138982@N08,1068,10,1259256471,1259257356,2,1,885
37138982@N08,1069,10,1270088424,1270088460,2,1,36
37138982@N08,1070,20,1280551826,1280551826,1,1,0
37138982@N08,1071,25,1303988788,1303988788,1,1,0
37574483@N07,1072,16,1335852900,1335854172,3,2,1272
37574483@N07,1072,1,1335854973,1335854973,1,2,0
37622685@N02,1073,10,1263528704,1263530707,3,1,2003
37622685@N02,1074,26,1263791441,1263791623,2,3,182
37622685@N02,1074,10,1263785497,1263785497,1,3,0
37622685@N02,1074,9,1263786607,1263786607,1,3,0
37809637@N00,1075,21,1343712445,1343712445,1,1,0
37912374670@N01,1076,15,1146217877,1146217877,1,1,0
37996595541@N01,1077,13,1276964722,1276964824,2,1,102
37996595541@N01,1078,13,1277028864,1277029055,4,1,191
37996595541@N01,1079,13,1277290095,1277290101,2,1,6
38166049@N00,1080,9,1197063686,1197069003,3,1,5317
38166049@N00,1081,27,1202532494,1202532997,2,1,503
38166049@N00,1082,13,1209268017,1209269156,5,3,1139
38166049@N00,1082,20,1209276881,1209277070,3,3,189
38166049@N00,1082,26,1209264617,1209264782,2,3,165
38826189@N00,1083,1,1155674079,1155682391,2,4,8312
38826189@N00,1083,9,1155686086,1155686392,4,4,306
38826189@N00,1083,11,1155666904,1155666997,3,4,93
38826189@N00,1083,16,1155674741,1155681467,8,4,6726
39244895@N08,1084,1,1353735976,1353735976,1,2,0
39244895@N08,1084,28,1353739156,1353739156,1,2,0
39517555@N06,1085,11,1299279895,1299279895,1,1,0
39573753@N00,1086,15,1184383060,1184383319,2,1,259
39573753@N00,1087,16,1184478940,1184483657,3,2,4717
39573753@N00,1087,28,1184473598,1184473598,1,2,0
39573753@N00,1088,15,1184551694,1184551856,3,1,162
39578657@N04,1089,2,1266589612,1266589623,2,2,11
39578657@N04,1089,7,1266588989,1266604326,3,2,15337
39578657@N04,1090,7,1269623917,1269623917,1,1,0
39578657@N04,1091,7,1275292678,1275326051,8,1,33373
39578657@N04,1092,7,1282226200,1282226306,2,1,106
39881171@N00,1093,29,1144922031,1144922031,1,1,0
39881171@N00,1094,19,1145027243,1145027243,1,1,0
39881171@N00,1095,19,1158853597,1158853646,2,1,49
40365132@N04,1096,22,1261914498,1261915046,3,1,548
40365132@N04,1097,22,1263004219,1263006916,4,1,2697
40365132@N04,1098,22,1272371414,1272371791,2,1,377
40365132@N04,1099,22,1276682210,1276683294,3,1,1084
40365132@N04,1100,22,1277607813,1277607837,3,1,24
40365132@N04,1101,22,1316926889,1316928677,5,1,1788
40511613@N00,1102,11,1241247226,1241247226,1,2,0
40511613@N00,1102,16,1241245089,1241245480,2,2,391
40571485@N00,1103,21,1380630736,1380631483,2,1,747
40631917@N04,1104,2,1293091828,1293092144,4,2,316
40631917@N04,1104,16,1293093641,1293093641,1,2,0
40631917@N04,1105,2,1296105776,1296118890,51,1,13114
40702610@N00,1106,16,1355496098,1355496098,1,1,0
40702610@N00,1107,28,1356089267,1356090848,12,1,1581
40942390@N00,1108,9,1170253985,1170253985,1,2,0
40942390@N00,1108,21,1170253985,1170253985,1,2,0
40942390@N00,1109,29,1174236847,1174236847,1,1,0
40942390@N00,1110,22,1174391167,1174391167,1,1,0
41143865@N00,1111,16,1165312412,1165312412,1,1,0
41143865@N00,1112,7,1169453625,1169453625,1,1,0
41143865@N00,1113,2,1170127908,1170127908,1,1,0
41143865@N00,1114,7,1170378619,1170378619,1,1,0
41143865@N00,1115,21,1170732086,1170732086,1,1,0
41143865@N00,1116,21,1171018264,1171018264,1,1,0
41143865@N00,1117,12,1172566097,1172566097,1,1,0
41143865@N00,1118,7,1175479038,1175479038,1,1,0
41143865@N00,1119,7,1232669397,1232669397,1,1,0
41153475@N04,1120,26,1347601593,1347606505,25,1,4912
41153475@N04,1121,16,1359161289,1359164247,7,2,2958
41153475@N04,1121,22,1359168720,1359168720,1,2,0
41418909@N06,1122,16,1332730359,1332730359,1,3,0
41418909@N06,1122,21,1332734010,1332734010,1,3,0
41418909@N06,1122,2,1332733738,1332733738,1,3,0
41568472@N00,1123,20,1179458640,1179458668,2,2,28
41568472@N00,1123,28,1179477805,1179477805,1,2,0
41715395@N00,1124,1,1334070693,1334070693,1,1,0
41838028@N00,1125,20,1124438796,1124438796,1,1,0
41894174966@N01,1126,1,1292475222,1292475570,5,3,348
41894174966@N01,1126,2,1292482919,1292483535,4,3,616
41894174966@N01,1126,21,1292475906,1292475906,1,3,0
42023707@N06,1127,16,1342321904,1342321904,1,1,0
42027916@N00,1128,10,1310420026,1310421606,13,2,1580
42027916@N00,1128,26,1310410963,1310416053,24,2,5090
42076226@N04,1129,24,1251525474,1251525474,1,1,0
42076226@N04,1130,26,1309853069,1309853069,1,1,0
42083039@N00,1131,1,1288067172,1288067172,3,1,0
42348675@N00,1132,28,1217654111,1217654111,1,1,0
42348675@N00,1133,26,1244084480,1244084748,2,1,268
42407623@N05,1134,21,1270455810,1270455810,1,1,0
42427406@N05,1135,1,1252931157,1252931157,1,1,0
42438338@N00,1136,19,1382603247,1382621478,2,1,18231
42503494@N00,1137,28,1260889516,1260889516,1,1,0
42588507@N04,1138,2,1295334236,1295334236,1,1,0
42772750@N06,1139,10,1234110773,1234110773,1,1,0
42772750@N06,1140,15,1238923284,1238923331,2,1,47
42772750@N06,1141,10,1267348603,1267348603,1,1,0
42772750@N06,1142,10,1269163956,1269163956,1,1,0
42772750@N06,1143,9,1273175145,1273178364,19,1,3219
42772750@N06,1144,16,1276322496,1276324424,7,1,1928
42772750@N06,1145,10,1286295677,1286295677,1,1,0
42772750@N06,1146,10,1287547467,1287547467,1,1,0
42772750@N06,1147,11,1288368739,1288368739,1,1,0
42772750@N06,1148,11,1288464943,1288464957,2,1,14
42772750@N06,1149,25,1294561487,1294561487,1,1,0
42772750@N06,1150,12,1295623183,1295630464,6,1,7281
42772750@N06,1151,9,1295862434,1295862434,1,1,0
42772750@N06,1152,11,1299248462,1299248462,1,1,0
42772750@N06,1153,16,1318092353,1318093072,5,1,719
42772750@N06,1154,16,1327141386,1327141386,1,1,0
42772750@N06,1155,12,1329407420,1329410220,5,1,2800
42772750@N06,1156,12,1329685859,1329685859,1,1,0
42772750@N06,1157,15,1331365687,1331365687,1,1,0
42772750@N06,1158,10,1332767352,1332767456,2,1,104
42907325@N00,1159,21,1375342666,1375342666,1,1,0
43002463@N00,1160,26,1203100870,1203105258,4,3,4388
43002463@N00,1160,10,1203107095,1203107613,7,3,518
43002463@N00,1160,9,1203107754,1203107754,1,3,0
43002463@N00,1161,2,1210838024,1210838024,1,1,0
43126182@N00,1162,13,1208932644,1208934610,3,1,1966
43126182@N00,1163,21,1208996165,1208996165,1,2,0
43126182@N00,1163,26,1209003990,1209009427,9,2,5437
43126182@N00,1164,1,1209042421,1209042421,1,1,0
43126182@N00,1165,1,1209156735,1209156735,1,1,0
43333831@N02,1166,21,1345120121,1345120121,1,1,0
43454521@N04,1167,11,1323215616,1323215616,1,1,0
43619118@N04,1168,22,1347775073,1347777705,2,1,2632
43638894@N00,1169,21,1387783367,1387803479,2,1,20112
43674804@N00,1170,16,1373338478,1373338536,2,1,58
43674804@N00,1171,19,1373591702,1373599075,7,1,7373
43982795@N03,1172,20,1180623600,1180623600,5,2,0
43982795@N03,1172,13,1180623600,1180623600,1,2,0
44124341325@N01,1173,1,1150343306,1150343306,1,1,0
44124341325@N01,1174,11,1169529054,1169529054,1,1,0
44124341325@N01,1175,11,1223553368,1223555657,2,1,2289
44124341325@N01,1176,26,1229000946,1229000946,1,1,0
44124341325@N01,1177,2,1231051237,1231051237,1,1,0
44124341325@N01,1178,16,1244712376,1244712376,1,1,0
44124341325@N01,1179,20,1245051059,1245051299,2,1,240
44124341325@N01,1180,12,1279343020,1279343020,1,1,0
44124341325@N01,1181,21,1296824194,1296824194,1,1,0
44124341325@N01,1182,28,1316426465,1316426465,1,1,0
44124341325@N01,1183,2,1324122382,1324122382,1,2,0
44124341325@N01,1183,20,1324112273,1324112273,1,2,0
44124341325@N01,1184,1,1324213254,1324213254,1,1,0
44124341325@N01,1185,16,1324460007,1324460007,1,1,0
44124341325@N01,1186,1,1340873989,1340873989,1,1,0
44124341325@N01,1187,28,1342185673,1342185673,1,1,0
44124341325@N01,1188,16,1343039287,1343039287,1,1,0
44124341325@N01,1189,28,1343296755,1343296755,1,1,0
44124341325@N01,1190,26,1347620110,1347620110,1,1,0
44124341325@N01,1191,15,1352368896,1352368896,1,1,0
44124341325@N01,1192,19,1352549509,1352549509,1,1,0
44124341325@N01,1193,20,1352887627,1352887627,1,1,0
44124341325@N01,1194,26,1355536483,1355536483,1,1,0
44124341325@N01,1195,2,1355746213,1355746213,1,1,0
44124341325@N01,1196,21,1356169804,1356169804,1,1,0
44124341325@N01,1197,1,1356970049,1356970049,1,1,0
44124341325@N01,1198,26,1358518185,1358518185,1,1,0
44124341325@N01,1199,11,1358662200,1358665909,2,1,3709
44124341325@N01,1200,11,1359185246,1359195550,2,1,10304
44124341325@N01,1201,26,1360933017,1360933017,1,1,0
44124341325@N01,1202,28,1372943685,1372943685,1,1,0
44124341325@N01,1203,10,1376534362,1376534362,1,1,0
44124341325@N01,1204,11,1378203756,1378203756,1,1,0
44124341325@N01,1205,12,1378724311,1378724311,1,1,0
44124341325@N01,1206,26,1397804221,1397804221,1,1,0
44124372821@N01,1207,28,1370587574,1370587574,1,2,0
44124372821@N01,1207,16,1370561978,1370561978,1,2,0
44124372821@N01,1208,2,1370636210,1370636210,1,1,0
44124372821@N01,1209,13,1395787181,1395787181,1,4,0
44124372821@N01,1209,28,1395797572,1395797572,1,4,0
44124372821@N01,1209,2,1395797995,1395797995,1,4,0
44124372821@N01,1209,26,1395805520,1395807064,3,4,1544
44124450371@N01,1210,29,1314537403,1314537403,1,1,0
44124450371@N01,1211,12,1314581035,1314581035,1,1,0
44232489@N02,1212,20,283964400,283964400,1,1,0
44232489@N02,1213,2,312822000,312822000,1,1,0
44232489@N02,1214,20,315500400,315500400,1,3,0
44232489@N02,1214,2,315500400,315500400,1,3,0
44232489@N02,1214,1,315500400,315500400,5,3,0
44232489@N02,1215,1,441730800,441730800,1,1,0
44232489@N02,1216,1,1266411036,1266411036,1,1,0
44232489@N02,1217,2,1341757802,1341757802,1,1,0
44457602@N00,1218,16,1277976502,1277976502,1,1,0
44457602@N00,1219,20,1354664213,1354664213,1,1,0
45072550@N03,1220,13,1383359593,1383363560,11,2,3967
45072550@N03,1220,21,1383373318,1383373318,1,2,0
45072550@N03,1221,16,1383461846,1383462031,4,5,185
45072550@N03,1221,21,1383461850,1383461867,3,5,17
45072550@N03,1221,13,1383447875,1383447966,2,5,91
45072550@N03,1221,9,1383451828,1383451853,2,5,25
45072550@N03,1221,2,1383447041,1383447041,1,5,0
45157110@N00,1222,20,1291509795,1291509842,2,1,47
45157110@N00,1223,20,1332045212,1332045212,1,1,0
45160304@N02,1224,2,1344361844,1344367547,13,1,5703
45211618@N00,1225,26,1347071886,1347071886,1,1,0
45359871@N00,1226,26,1209014310,1209014658,2,2,348
45359871@N00,1226,25,1209017784,1209018122,2,2,338
45581782@N00,1227,29,1331769389,1331769389,1,1,0
46187719@N00,1228,25,1350096366,1350096366,1,1,0
46325849@N03,1229,11,1383457423,1383457488,3,1,65
46453341@N00,1230,2,1340232877,1340234378,2,1,1501
46589452@N00,1231,11,1244888999,1244894962,17,1,5963
46680096@N03,1232,19,1342533533,1342533533,1,1,0
46680096@N03,1233,25,1345451796,1345451796,1,2,0
46680096@N03,1233,26,1345449112,1345449516,4,2,404
46680096@N03,1234,15,1348295277,1348295340,2,1,63
46680096@N03,1235,26,1354175997,1354175997,1,2,0
46680096@N03,1235,9,1354175400,1354175400,1,2,0
46680096@N03,1236,28,1370666193,1370666193,1,1,0
46680096@N03,1237,25,1370758203,1370758203,1,1,0
46841206@N00,1238,8,1162260605,1162260605,1,1,0
46841206@N00,1239,2,1162875824,1162875824,1,1,0
46841206@N00,1240,1,1210768522,1210768522,1,1,0
46922409@N00,1241,16,1213942197,1213942197,1,1,0
46922409@N00,1242,9,1224129058,1224129058,1,1,0
47229442@N06,1243,7,1335233799,1335238487,24,1,4688
47229442@N06,1244,21,1337128240,1337140023,52,1,11783
47229455@N04,1245,18,1353066303,1353066303,1,1,0
47702663@N00,1246,10,1386733049,1386733049,1,1,0
47748555@N00,1247,15,1284010727,1284010727,1,1,0
48001787@N06,1248,2,1282795030,1282795101,2,3,71
48001787@N06,1248,20,1282795211,1282795211,1,3,0
48001787@N06,1248,26,1282797636,1282797636,1,3,0
48001787@N06,1249,2,1341191503,1341201424,17,1,9921
48001787@N06,1250,2,1356318100,1356318100,1,1,0
48122140@N00,1251,16,1370773654,1370773654,1,1,0
48122140@N00,1252,12,1370850568,1370850568,1,1,0
48122140@N00,1253,2,1370915670,1370915670,1,1,0
48193147@N00,1254,11,1296883737,1296883737,1,1,0
48321512@N06,1255,2,1368856852,1368857847,3,2,995
48321512@N06,1255,21,1368863968,1368863976,3,2,8
48355243@N00,1256,21,1290658593,1290673719,2,1,15126
48355243@N00,1257,10,1369715588,1369715588,1,2,0
48355243@N00,1257,16,1369727508,1369727508,1,2,0
48762356@N00,1258,2,1228193150,1228194650,4,1,1500
48762356@N00,1259,20,1281848575,1281848575,1,1,0
48762356@N00,1260,11,1289619306,1289619306,1,1,0
48762356@N00,1261,21,1313575142,1313575142,1,1,0
48889035097@N01,1262,2,1207045691,1207045691,1,1,0
48889035097@N01,1263,2,1228803761,1228803761,1,1,0
48889035097@N01,1264,15,1232344027,1232344027,1,1,0
48889035097@N01,1265,15,1232667452,1232667452,1,1,0
48889035097@N01,1266,22,1249103632,1249103632,1,1,0
48889035097@N01,1267,20,1254050708,1254050708,1,1,0
48889035097@N01,1268,2,1262495878,1262495878,1,1,0
48889035097@N01,1269,22,1266249692,1266249692,1,1,0
48889035097@N01,1270,20,1269770511,1269771439,3,1,928
48889035097@N01,1271,1,1289797177,1289797177,1,1,0
48889119704@N01,1272,7,980768365,980775865,22,1,7500
48889119704@N01,1273,24,1067673496,1067673496,1,1,0
48889119704@N01,1274,24,1133865337,1133865337,1,1,0
48889119704@N01,1275,19,1264662094,1264662094,1,1,0
48889119704@N01,1276,24,1264822215,1264836319,2,2,14104
48889119704@N01,1276,19,1264807954,1264807954,1,2,0
48889119704@N01,1277,24,1295071161,1295071640,3,1,479
48889119704@N01,1278,24,1296642558,1296644130,2,1,1572
48889119704@N01,1279,24,1296961752,1296968901,26,1,7149
48889119704@N01,1280,24,1298790152,1298790152,1,1,0
48889119704@N01,1281,24,1300359642,1300365582,6,1,5940
48889119704@N01,1282,24,1301723928,1301728129,4,1,4201
48889119704@N01,1283,24,1302937841,1302938076,2,1,235
48889119704@N01,1284,24,1304743566,1304743566,1,1,0
48889119704@N01,1285,24,1305025858,1305031313,3,1,5455
48889119704@N01,1286,16,1307682931,1307682931,1,1,0
48889119704@N01,1287,24,1316316527,1316323297,5,1,6770
48889119704@N01,1288,24,1325490560,1325490560,1,1,0
48902193@N00,1289,1,1169774294,1169774370,3,1,76
48902193@N00,1290,7,1272416809,1272420779,3,1,3970
49066397@N07,1291,2,1381049184,1381049184,1,1,0
49253583@N02,1292,28,1304074866,1304074866,1,3,0
49253583@N02,1292,12,1304067999,1304075585,3,3,7586
49253583@N02,1292,11,1304067831,1304077498,4,3,9667
49503076502@N01,1293,11,896626800,896626800,1,1,0
49503126065@N01,1294,13,1386044242,1386044242,1,2,0
49503126065@N01,1294,16,1386053959,1386053959,1,2,0
49998283@N00,1295,12,1209456528,1209456528,1,3,0
49998283@N00,1295,28,1209456179,1209456179,1,3,0
49998283@N00,1295,13,1209433860,1209455792,26,3,21932
49998283@N00,1296,11,1209605745,1209611552,7,4,5807
49998283@N00,1296,28,1209611063,1209611063,1,4,0
49998283@N00,1296,2,1209612822,1209612822,1,4,0
49998283@N00,1296,20,1209611880,1209612320,2,4,440
50375509@N00,1297,2,1384501061,1384501061,1,1,0
50375509@N00,1298,7,1391756114,1391756114,1,1,0
50422902@N07,1299,28,1337225100,1337225100,1,1,0
50746716@N06,1300,2,1317984815,1317984815,1,1,0
51035728226@N01,1301,12,1280283756,1280283756,1,1,0
51035765257@N01,1302,2,1283588821,1283588821,1,1,0
51168133@N00,1303,2,1217835184,1217840096,2,5,4912
51168133@N00,1303,10,1217841113,1217844007,5,5,2894
51168133@N00,1303,16,1217835960,1217835960,1,5,0
51168133@N00,1303,21,1217835226,1217836255,3,5,1029
51168133@N00,1303,13,1217838641,1217838794,2,5,153
51207064@N00,1304,15,1150243312,1150244055,2,1,743
51207064@N00,1305,16,1187564863,1187564863,1,1,0
51207064@N00,1306,16,1188000056,1188000393,4,1,337
51207064@N00,1307,20,1190440627,1190440652,2,1,25
51207064@N00,1308,21,1195724204,1195724204,1,1,0
51207064@N00,1309,21,1196681766,1196681766,1,1,0
51207064@N00,1310,15,1199163849,1199163849,1,1,0
51207064@N00,1311,16,1199691554,1199691554,1,1,0
51207064@N00,1312,1,1200557649,1200557716,2,1,67
51207064@N00,1313,16,1203644189,1203644189,1,1,0
51207064@N00,1314,15,1211596486,1211596486,1,1,0
51207064@N00,1315,21,1217650113,1217650113,1,3,0
51207064@N00,1315,16,1217644868,1217644868,1,3,0
51207064@N00,1315,2,1217649446,1217650058,7,3,612
51207064@N00,1316,14,1225511598,1225511598,1,1,0
51207064@N00,1317,20,1227933554,1227933554,1,1,0
51207064@N00,1318,2,1228546263,1228546263,1,1,0
51207064@N00,1319,21,1228816484,1228816670,3,1,186
51207064@N00,1320,2,1234581812,1234581872,4,1,60
51207064@N00,1321,1,1238702424,1238702424,1,1,0
51207064@N00,1322,20,1387925864,1387925864,1,3,0
51207064@N00,1322,12,1387925771,1387926347,3,3,576
51207064@N00,1322,2,1387926058,1387926276,2,3,218
51272891@N00,1323,21,1184500014,1184500014,1,2,0
51272891@N00,1323,2,1184500456,1184500662,2,2,206
52043939@N00,1324,10,1219993564,1219995012,24,1,1448
52043939@N00,1325,10,1252855804,1252855804,1,1,0
52043939@N00,1326,9,1277976231,1277977098,15,1,867
52043939@N00,1327,19,1292752771,1292752890,2,1,119
52043939@N00,1328,2,1314077493,1314078214,16,1,721
52043939@N00,1329,10,1325737498,1325737577,3,1,79
52043939@N00,1330,10,1379657496,1379657496,1,1,0
52686644@N04,1331,20,1330252170,1330252293,2,1,123
52686644@N04,1332,12,1335583883,1335585961,2,1,2078
52686644@N04,1333,12,1341029386,1341035747,30,2,6361
52686644@N04,1333,2,1341040326,1341040328,4,2,2
52686644@N04,1334,28,1344327496,1344327496,1,5,0
52686644@N04,1334,16,1344329247,1344329247,1,5,0
52686644@N04,1334,20,1344323686,1344324223,3,5,537
52686644@N04,1334,1,1344329790,1344329805,2,5,15
52686644@N04,1334,12,1344328861,1344329406,9,5,545
52686644@N04,1335,28,1356863842,1356863842,1,1,0
52686644@N04,1336,1,1361675261,1361675261,1,1,0
52721565@N00,1337,19,1384071585,1384071585,1,1,0
52947246@N00,1338,13,1079494418,1079496861,5,1,2443
52947246@N00,1339,13,1099637791,1099639613,2,1,1822
52947246@N00,1340,13,1157187021,1157187021,1,1,0
53016579@N00,1341,15,1322890416,1322890416,1,1,0
53016579@N00,1342,15,1340063883,1340064102,2,2,219
53016579@N00,1342,10,1340083114,1340083114,1,2,0
53016579@N00,1343,10,1377675121,1377675121,1,1,0
53579671@N08,1344,11,1313734204,1313735460,8,2,1256
53579671@N08,1344,20,1313731809,1313731809,1,2,0
53627666@N00,1345,13,1171814981,1171814981,2,1,0
53627666@N00,1346,13,1171882425,1171882426,2,1,1
53627666@N00,1347,21,1172147116,1172147116,2,2,0
53627666@N00,1347,13,1172123489,1172152168,5,2,28679
53627666@N00,1348,13,1172838243,1172838243,1,1,0
53627666@N00,1349,7,1172952007,1172952007,1,2,0
53627666@N00,1349,13,1172928324,1172928324,1,2,0
53627666@N00,1350,13,1173019906,1173019906,1,2,0
53627666@N00,1350,7,1173018215,1173018215,1,2,0
53627666@N00,1351,19,1174568374,1174568374,1,1,0
53627666@N00,1352,19,1176216844,1176216844,1,1,0
53650733@N06,1353,13,1372827271,1372829452,7,2,2181
53650733@N06,1353,29,1372838691,1372838691,1,2,0
53650733@N06,1354,1,1372911909,1372912241,3,1,332
53650733@N06,1355,29,1373262130,1373263253,5,1,1123
53650733@N06,1356,26,1373345986,1373346048,2,1,62
53650733@N06,1357,29,1373425277,1373435222,3,1,9945
53933526@N02,1358,25,1384683048,1384683048,1,2,0
53933526@N02,1358,19,1384670655,1384670655,1,2,0
54133975@N08,1359,20,1327323482,1327323482,1,1,0
54133975@N08,1360,1,1327415377,1327415617,2,1,240
54444377@N00,1361,15,1382250889,1382250889,1,1,0
54444377@N00,1362,13,1384652923,1384655468,4,1,2545
54458860@N00,1363,24,1263082271,1263082271,1,1,0
54458860@N00,1364,2,1264825716,1264825716,1,2,0
54458860@N00,1364,21,1264828992,1264828992,1,2,0
54458860@N00,1365,2,1266021843,1266021843,1,1,0
54458860@N00,1366,15,1272848444,1272848444,1,1,0
54458860@N00,1367,15,1273224170,1273224170,1,1,0
54549576@N00,1368,19,1242814959,1242815076,6,1,117
54549576@N00,1369,19,1295938565,1295938565,1,1,0
54799099@N00,1370,2,1189208668,1189208668,1,1,0
55329285@N05,1371,10,1291103864,1291104942,3,1,1078
55329285@N05,1372,10,1292207860,1292208826,15,1,966
55329285@N05,1373,10,1295423906,1295427493,9,1,3587
55329285@N05,1374,10,1295511404,1295511463,4,2,59
55329285@N05,1374,9,1295511498,1295511555,3,2,57
55329285@N05,1375,12,1295615931,1295633086,43,1,17155
55329285@N05,1376,10,1296200587,1296200666,4,1,79
55329285@N05,1377,10,1297049947,1297050231,2,2,284
55329285@N05,1377,15,1297047639,1297048068,3,2,429
55329285@N05,1378,15,1297396743,1297399839,22,1,3096
55329285@N05,1379,9,1297827241,1297827552,10,2,311
55329285@N05,1379,10,1297827046,1297832516,80,2,5470
55329285@N05,1380,10,1298101304,1298101851,4,2,547
55329285@N05,1380,15,1298103976,1298105056,5,2,1080
55329285@N05,1381,10,1298882789,1298891061,7,1,8272
55329285@N05,1382,10,1298955655,1298955655,1,3,0
55329285@N05,1382,15,1298962649,1298981805,17,3,19156
55329285@N05,1382,9,1298955156,1298955512,5,3,356
55329285@N05,1383,10,1299033062,1299050907,10,1,17845
55329285@N05,1384,10,1299121697,1299134598,10,2,12901
55329285@N05,1384,15,1299144923,1299146661,10,2,1738
55329285@N05,1385,15,1299825007,1299835534,30,1,10527
55329285@N05,1386,10,1300770632,1300773255,17,1,2623
55329285@N05,1387,10,1301022639,1301027210,20,1,4571
55329285@N05,1388,10,1301727781,1301727815,2,1,34
55329285@N05,1389,9,1302164365,1302164379,2,1,14
55329285@N05,1390,10,1305886402,1305902667,60,1,16265
55329285@N05,1391,11,1307011215,1307013760,12,2,2545
55329285@N05,1391,10,1306999355,1306999975,8,2,620
55329285@N05,1392,9,1307254175,1307255415,16,1,1240
55329285@N05,1393,10,1308127744,1308128318,7,1,574
55329285@N05,1394,22,1309257437,1309274381,15,1,16944
55329285@N05,1395,10,1313394629,1313395404,16,1,775
55329285@N05,1396,10,1315720398,1315720398,1,1,0
55329285@N05,1397,10,1315792314,1315801073,66,1,8759
55329285@N05,1398,10,1315887367,1315889815,8,1,2448
55329285@N05,1399,1,1316005903,1316016748,26,3,10845
55329285@N05,1399,10,1315984849,1315998618,20,3,13769
55329285@N05,1399,9,1315973796,1315974380,4,3,584
55329285@N05,1400,10,1316068862,1316069876,3,1,1014
55329285@N05,1401,10,1326691451,1326700697,3,1,9246
55329285@N05,1402,10,1326773872,1326785891,6,1,12019
55329285@N05,1403,10,1326860303,1326867943,5,1,7640
55329285@N05,1404,10,1326950463,1326957878,3,1,7415
55329285@N05,1405,10,1327033105,1327037095,2,1,3990
55329285@N05,1406,10,1327471435,1327476065,5,1,4630
55329285@N05,1407,10,1331023894,1331033285,51,1,9391
55329285@N05,1408,10,1331104549,1331107155,12,1,2606
55329285@N05,1409,10,1331185980,1331202615,19,1,16635
55329285@N05,1410,10,1331525604,1331527986,30,1,2382
55329285@N05,1411,10,1332234505,1332237636,56,1,3131
55329285@N05,1412,10,1332490918,1332497594,82,1,6676
55377698@N00,1413,1,1224295789,1224295789,1,2,0
55377698@N00,1413,16,1224293303,1224294243,2,2,940
55377698@N00,1414,13,1224373369,1224375268,3,1,1899
55898913@N04,1415,6,1328264336,1328264336,1,5,0
55898913@N04,1415,26,1328247325,1328249695,7,5,2370
55898913@N04,1415,16,1328239337,1328240053,4,5,716
55898913@N04,1415,2,1328245022,1328245281,5,5,259
55898913@N04,1415,1,1328223607,1328238411,2,5,14804
55898913@N04,1416,1,1328313865,1328313865,1,1,0
55915075@N05,1417,13,1192630436,1192630436,1,1,0
55915075@N05,1418,13,1192666638,1192666638,1,1,0
56053592@N00,1419,1,1367177585,1367177585,1,1,0
56116019@N00,1420,2,1125714098,1125714098,1,1,0
56335302@N00,1421,15,1320999805,1320999805,1,1,0
56339323@N00,1422,26,1269574474,1269574480,2,1,6
56355370@N00,1423,13,1353976718,1353976718,1,1,0
56658926@N08,1424,20,1304153431,1304153431,1,2,0
56658926@N08,1424,13,1304147165,1304147165,1,2,0
56846157@N00,1425,16,1369806242,1369806242,1,5,0
56846157@N00,1425,10,1369794752,1369795241,5,5,489
56846157@N00,1425,15,1369796662,1369798192,3,5,1530
56846157@N00,1425,11,1369804755,1369804878,2,5,123
56846157@N00,1425,21,1369807023,1369807148,3,5,125
56889160@N00,1426,19,1379274320,1379274320,1,1,0
56889160@N00,1427,16,1379360144,1379360144,1,1,0
56889878@N03,1428,2,1344308630,1344308630,1,3,0
56889878@N03,1428,12,1344331671,1344331671,1,3,0
56889878@N03,1428,28,1344314129,1344314129,1,3,0
56889878@N03,1429,2,1344395614,1344395614,1,1,0
56889878@N03,1430,1,1344528752,1344528752,1,2,0
56889878@N03,1430,6,1344510869,1344510869,1,2,0
56889878@N03,1431,2,1344574269,1344574269,1,1,0
56889878@N03,1432,22,1344682126,1344682126,1,1,0
57058232@N02,1433,12,1373801293,1373801293,1,2,0
57058232@N02,1433,1,1373800799,1373800799,1,2,0
57058232@N02,1434,25,1373956994,1373956994,1,1,0
57058232@N02,1435,25,1374035541,1374035612,3,1,71
57058232@N02,1436,25,1374115398,1374129593,2,1,14195
57071639@N00,1437,21,1235964418,1235964418,1,1,0
57386290@N00,1438,10,1316236461,1316236461,1,1,0
57474170@N05,1439,16,1357362917,1357362917,1,1,0
57474170@N05,1440,19,1357473742,1357474289,32,4,547
57474170@N05,1440,20,1357482072,1357483440,10,4,1368
57474170@N05,1440,2,1357457685,1357481644,4,4,23959
57474170@N05,1440,21,1357457678,1357457678,1,4,0
57511216@N04,1441,24,1350712840,1350716805,2,1,3965
57774948@N04,1442,2,1382768851,1382768851,1,1,0
57879122@N00,1443,21,1275195783,1275195783,1,4,0
57879122@N00,1443,2,1275190655,1275204121,2,4,13466
57879122@N00,1443,28,1275207225,1275207225,1,4,0
57879122@N00,1443,16,1275192911,1275203546,4,4,10635
57879122@N00,1444,16,1329535150,1329536773,3,2,1623
57879122@N00,1444,13,1329547604,1329547604,1,2,0
57879122@N00,1445,15,1329624433,1329624433,1,2,0
57879122@N00,1445,20,1329642420,1329642973,2,2,553
57899800@N00,1446,15,1352085944,1352086108,8,1,164
57899800@N00,1447,16,1354586326,1354586326,1,1,0
57899800@N00,1448,11,1397796076,1397796076,1,1,0
57925378@N06,1449,12,1351511309,1351511309,1,1,0
57979713@N03,1450,28,1299785836,1299785836,1,1,0
58366288@N07,1451,11,1336180920,1336180920,1,1,0
58502702@N03,1452,21,1299250812,1299250812,1,1,0
58502702@N03,1453,22,1336921204,1336921209,4,1,5
59002912@N08,1454,26,1343239325,1343241236,11,2,1911
59002912@N08,1454,28,1343239413,1343239525,4,2,112
59002912@N08,1455,13,1345004173,1345004366,6,1,193
59271446@N00,1456,19,1235271301,1235271301,1,1,0
59595694@N08,1457,28,1326209195,1326209195,1,1,0
59774354@N00,1458,14,1162717200,1162717200,1,1,0
60006733@N05,1459,22,1299140418,1299140418,1,1,0
60006733@N05,1460,26,1311292530,1311292573,2,1,43
60006733@N05,1461,13,1330757557,1330759725,3,1,2168
60006733@N05,1462,27,1331788173,1331788173,1,1,0
60305812@N05,1463,1,993913200,993913200,1,1,0
60576086@N00,1464,11,1226158944,1226162748,32,1,3804
60576086@N00,1465,2,1226724395,1226725307,5,1,912
60576086@N00,1466,11,1226758550,1226770668,18,1,12118
60778003@N00,1467,13,1178254706,1178256583,7,1,1877
60778003@N00,1468,13,1222833746,1222833746,1,1,0
60992359@N05,1469,13,1188713918,1188713918,1,1,0
61132483@N00,1470,19,1183950889,1183950889,1,1,0
61132483@N00,1471,12,1184052152,1184052152,1,1,0
61283368@N00,1472,20,1376170688,1376171935,3,1,1247
61283368@N00,1473,20,1376259027,1376259027,1,1,0
61753503@N00,1474,19,1253637176,1253637176,1,1,0
62136333@N02,1475,2,1035419753,1035434320,9,1,14567
62136333@N02,1476,2,1035508411,1035526555,15,1,18144
62136333@N02,1477,19,1194767033,1194767828,22,2,795
62136333@N02,1477,2,1194743425,1194743425,1,2,0
62136333@N02,1478,2,1194848947,1194850968,19,1,2021
62376436@N00,1479,1,1255824556,1255824556,1,1,0
62457680@N00,1480,12,1340706747,1340706747,1,1,0
62525091@N00,1481,9,1184911541,1184911541,1,1,0
62525091@N00,1482,9,1186476980,1186476980,1,1,0
62525091@N00,1483,9,1187182200,1187182556,2,1,356
62525091@N00,1484,9,1187264374,1187268628,4,1,4254
62798459@N00,1485,16,1305433531,1305433531,1,1,0
62798459@N00,1486,20,1329398123,1329398123,1,1,0
62798459@N00,1487,20,1333455822,1333455822,1,1,0
62798459@N00,1488,16,1351829100,1351829100,1,1,0
62798459@N00,1489,16,1356143001,1356143001,1,1,0
62798459@N00,1490,1,1376983759,1376984128,2,2,369
62798459@N00,1490,21,1376985597,1376985658,2,2,61
62798459@N00,1491,2,1378356045,1378356045,1,1,0
62798459@N00,1492,16,1378611548,1378614033,4,2,2485
62798459@N00,1492,2,1378613392,1378613392,1,2,0
62798459@N00,1493,28,1380882261,1380882766,2,2,505
62798459@N00,1493,20,1380883401,1380891143,2,2,7742
62798459@N00,1494,16,1397007674,1397019543,4,3,11869
62798459@N00,1494,12,1397016748,1397017213,2,3,465
62798459@N00,1494,8,1397012240,1397012240,1,3,0
62993924@N00,1495,16,1320555006,1320555006,1,2,0
62993924@N00,1495,2,1320553919,1320553919,1,2,0
62993924@N00,1496,16,1320646332,1320646332,1,1,0
63068627@N00,1497,17,1178071376,1178071376,1,1,0
63252722@N00,1498,16,1335733550,1335733550,1,2,0
63252722@N00,1498,28,1335749073,1335749073,1,2,0
63252722@N00,1499,28,1335810545,1335810545,1,1,0
63252722@N00,1500,12,1335844136,1335844136,1,1,0
63457884@N04,1501,17,1334276031,1334293621,4,1,17590
63457884@N04,1502,17,1334364219,1334364219,1,1,0
63457884@N04,1503,13,1334538793,1334538933,2,1,140
63457884@N04,1504,2,1335085144,1335085144,1,1,0
63458311@N00,1505,13,1217819664,1217819664,1,1,0
63651050@N00,1506,11,1353660016,1353660016,2,3,0
63651050@N00,1506,1,1353655537,1353655540,4,3,3
63651050@N00,1506,13,1353652830,1353652830,1,3,0
63974928@N00,1507,2,1260932381,1260932607,5,1,226
63974928@N00,1508,21,1361921845,1361921845,1,2,0
63974928@N00,1508,2,1361921844,1361921844,1,2,0
63974928@N00,1509,21,1362286345,1362286345,1,1,0
63999590@N00,1510,15,1242251364,1242251364,1,2,0
63999590@N00,1510,26,1242244884,1242249375,4,2,4491
64816608@N00,1511,11,1208417461,1208417461,1,1,0
64816608@N00,1512,26,1210041111,1210041226,2,1,115
64830478@N03,1513,26,1384661688,1384669356,3,1,7668
64865208@N00,1514,28,1249775619,1249775619,1,1,0
64865208@N00,1515,15,1249808377,1249808377,1,1,0
65072601@N00,1516,19,1113970156,1113977896,2,1,7740
65244239@N00,1517,19,1159602613,1159602613,1,3,0
65244239@N00,1517,26,1159608042,1159608042,1,3,0
65244239@N00,1517,25,1159607435,1159607435,1,3,0
65331856@N00,1518,7,1129451760,1129451760,1,1,0
65331856@N00,1519,20,1137400907,1137400907,1,1,0
65331856@N00,1520,26,1160276473,1160280460,3,1,3987
65331856@N00,1521,21,1195907049,1195907049,1,1,0
65393953@N03,1522,11,1308113107,1308113107,1,1,0
65393953@N03,1523,13,1347676607,1347677795,4,1,1188
65393953@N03,1524,10,1353125459,1353128064,8,1,2605
65393953@N03,1525,25,1369450349,1369450349,1,2,0
65393953@N03,1525,26,1369452044,1369452044,1,2,0
65698233@N00,1526,29,1268694915,1268694915,1,1,0
65849099@N00,1527,21,1184493471,1184493471,1,1,0
66058127@N00,1528,16,1177994229,1177994229,1,1,0
66367850@N00,1529,2,1249976314,1249977161,10,1,847
66656285@N00,1530,19,1346826741,1346826741,1,1,0
66947039@N00,1531,2,1216744783,1216744783,1,1,0
66947039@N00,1532,13,1216844991,1216846840,4,1,1849
66994036@N00,1533,26,1170135267,1170135267,1,1,0
66994036@N00,1534,1,1175665948,1175665948,1,2,0
66994036@N00,1534,15,1175665901,1175665901,1,2,0
66994036@N00,1535,26,1217482983,1217482983,1,1,0
66994036@N00,1536,10,1251872919,1251873096,2,2,177
66994036@N00,1536,25,1251871860,1251872010,2,2,150
67008765@N00,1537,26,1219816127,1219816137,2,2,10
67008765@N00,1537,25,1219813971,1219813971,1,2,0
67008765@N00,1538,26,1243048240,1243054306,132,1,6066
67258954@N00,1539,21,1293607917,1293607917,1,1,0
67258954@N00,1540,26,1293687003,1293687003,1,1,0
67258954@N00,1541,15,1305952227,1305952227,1,1,0
67258954@N00,1542,16,1305988031,1305988031,1,1,0
67258954@N00,1543,15,1397913666,1397913666,1,1,0
67265930@N00,1544,7,1198655270,1198655270,1,1,0
68026101@N00,1545,7,1162651514,1162651569,3,1,55
68493542@N00,1546,20,1350431824,1350431824,1,1,0
68497070@N00,1547,15,1230102364,1230102364,1,1,0
68497070@N00,1548,16,1258773602,1258773728,2,1,126
68497070@N00,1549,15,1258811780,1258811780,1,1,0
68537341@N00,1550,21,1209191097,1209192042,5,1,945
68688301@N00,1551,2,1169990654,1169990654,1,1,0
68791731@N00,1552,26,1206247372,1206247393,4,2,21
68791731@N00,1552,1,1206250246,1206250290,4,2,44
68992643@N00,1553,14,1200742338,1200742338,1,1,0
69105772@N03,1554,21,1343379276,1343380782,2,1,1506
69105772@N03,1555,2,1357327117,1357327117,1,2,0
69105772@N03,1555,22,1357327110,1357327110,1,2,0
69105772@N03,1556,16,1357652797,1357652797,1,1,0
69959962@N00,1557,11,1273958298,1273958359,2,1,61
69984505@N07,1558,10,1374041448,1374052814,4,1,11366
70284683@N06,1559,16,1203588816,1203588816,1,3,0
70284683@N06,1559,21,1203588669,1203588745,4,3,76
70284683@N06,1559,8,1203584625,1203587253,5,3,2628
70284683@N06,1560,19,1204428466,1204428560,2,1,94
70284683@N06,1561,19,1206134589,1206134589,1,1,0
70284683@N06,1562,2,1227002998,1227002998,1,2,0
70284683@N06,1562,21,1227003209,1227003209,1,2,0
70284683@N06,1563,2,1236232024,1236236896,3,1,4872
70284683@N06,1564,20,1242708931,1242708936,2,1,5
70284683@N06,1565,20,1253190811,1253196716,4,1,5905
70284683@N06,1566,8,1267369200,1267369200,40,1,0
70284683@N06,1567,8,1270047600,1270047600,1,1,0
70284683@N06,1568,20,1272343646,1272345122,4,1,1476
70284683@N06,1569,8,1285215361,1285215361,1,1,0
70284683@N06,1570,8,1285296604,1285296640,8,1,36
70284683@N06,1571,8,1287641536,1287641537,2,1,1
70284683@N06,1572,2,1290524416,1290524423,8,1,7
70284683@N06,1573,2,1326381093,1326381093,1,1,0
70544918@N00,1574,11,1291289654,1291295457,3,1,5803
70544918@N00,1575,16,1295481555,1295481555,1,1,0
70544918@N00,1576,1,1296119814,1296119814,1,1,0
70544918@N00,1577,11,1297249972,1297254271,4,1,4299
70544918@N00,1578,20,1297412564,1297412564,1,1,0
70544918@N00,1579,11,1297917343,1297917343,1,1,0
70544918@N00,1580,21,1298018952,1298022397,2,1,3445
70544918@N00,1581,2,1298295919,1298295919,1,1,0
70544918@N00,1582,2,1298366099,1298366099,1,1,0
70544918@N00,1583,16,1298448424,1298458165,3,1,9741
70544918@N00,1584,1,1299490505,1299490505,1,1,0
70544918@N00,1585,21,1299577338,1299577338,1,1,0
70544918@N00,1586,20,1299767125,1299767125,1,1,0
70544918@N00,1587,2,1299832297,1299832699,2,1,402
70544918@N00,1588,16,1300270206,1300270206,1,1,0
70544918@N00,1589,2,1300681355,1300681355,1,1,0
70544918@N00,1590,12,1300773398,1300773398,1,1,0
70544918@N00,1591,20,1300941319,1300941319,1,1,0
70544918@N00,1592,16,1301017125,1301026746,2,1,9621
70544918@N00,1593,16,1301566989,1301566989,1,1,0
70544918@N00,1594,15,1301730925,1301730925,1,1,0
70544918@N00,1595,14,1301999236,1301999236,1,1,0
70544918@N00,1596,16,1302063002,1302063002,1,1,0
70544918@N00,1597,20,1302168439,1302168439,1,1,0
70544918@N00,1598,11,1302603010,1302603010,1,1,0
70544918@N00,1599,12,1302660280,1302660280,1,1,0
70544918@N00,1600,12,1302826406,1302826406,1,1,0
70544918@N00,1601,1,1303117731,1303117731,1,1,0
70544918@N00,1602,28,1303376260,1303376260,1,1,0
70544918@N00,1603,12,1303776689,1303776689,1,1,0
70544918@N00,1604,12,1305158382,1305158382,1,1,0
70544918@N00,1605,12,1305702171,1305702171,1,1,0
70544918@N00,1606,12,1306406415,1306406415,1,1,0
70544918@N00,1607,11,1306581871,1306581871,1,1,0
70544918@N00,1608,21,1307620672,1307620672,1,1,0
70544918@N00,1609,12,1308119199,1308119199,1,1,0
70544918@N00,1610,20,1308577885,1308577885,1,1,0
70544918@N00,1611,15,1308917082,1308921375,2,1,4293
70544918@N00,1612,15,1308976932,1308980842,2,1,3910
70544918@N00,1613,12,1309492490,1309492490,1,1,0
70544918@N00,1614,2,1318972085,1318972085,1,1,0
70544918@N00,1615,12,1321500968,1321500968,1,1,0
70544918@N00,1616,15,1323579913,1323580050,2,1,137
70544918@N00,1617,12,1323844202,1323844319,2,1,117
70544918@N00,1618,11,1323950282,1323950282,1,1,0
70544918@N00,1619,1,1324614377,1324618246,2,1,3869
70544918@N00,1620,12,1326851685,1326851685,1,1,0
70544918@N00,1621,10,1327548480,1327548690,3,1,210
70544918@N00,1622,15,1328939448,1328939448,1,1,0
70544918@N00,1623,12,1330067050,1330067050,1,1,0
70544918@N00,1624,11,1331981741,1331981824,2,1,83
70544918@N00,1625,1,1333687109,1333687109,1,1,0
70544918@N00,1626,12,1335711032,1335711032,1,1,0
70544918@N00,1627,12,1337072540,1337072540,1,1,0
70544918@N00,1628,12,1338106686,1338106686,1,1,0
70544918@N00,1629,12,1338158093,1338195588,3,1,37495
70544918@N00,1630,16,1338800984,1338800984,1,1,0
70544918@N00,1631,12,1340281577,1340281577,1,2,0
70544918@N00,1631,11,1340281558,1340281558,1,2,0
70544918@N00,1632,12,1342277953,1342277953,1,3,0
70544918@N00,1632,21,1342277933,1342277933,1,3,0
70544918@N00,1632,15,1342277918,1342277918,1,3,0
70544918@N00,1633,12,1342414582,1342414582,1,1,0
70544918@N00,1634,12,1343560963,1343560963,1,1,0
70544918@N00,1635,21,1344006133,1344006133,1,1,0
70544918@N00,1636,12,1345368429,1345368429,1,1,0
70544918@N00,1637,12,1347691894,1347691928,2,1,34
70544918@N00,1638,2,1363863588,1363864801,3,1,1213
70544918@N00,1639,28,1370774820,1370774820,1,1,0
70641280@N00,1640,22,1328506419,1328506419,1,1,0
70641280@N00,1641,20,1335577585,1335577585,1,1,0
70641280@N00,1642,20,1335664323,1335664323,1,1,0
70641280@N00,1643,16,1350108062,1350108062,1,1,0
70641280@N00,1644,22,1358145105,1358145105,1,1,0
70641280@N00,1645,22,1362637517,1362637517,1,1,0
70641280@N00,1646,12,1368948466,1368948466,1,2,0
70641280@N00,1646,16,1368944596,1368944596,1,2,0
70641280@N00,1647,22,1374208711,1374208711,1,1,0
70641280@N00,1648,2,1385724653,1385724653,1,1,0
70641280@N00,1649,12,1390566479,1390566479,1,1,0
70641280@N00,1650,2,1392292317,1392292317,1,1,0
70889174@N04,1651,10,1234034920,1234034920,1,1,0
70938076@N00,1652,26,1218947115,1218947115,1,1,0
70938076@N00,1653,16,1234503262,1234503262,1,1,0
70938076@N00,1654,16,1239849208,1239849208,1,1,0
70938076@N00,1655,16,1240042819,1240042819,1,1,0
70938076@N00,1656,16,1245900665,1245900665,1,1,0
70938076@N00,1657,16,1246871863,1246871863,1,1,0
70938076@N00,1658,2,1248028841,1248028841,1,1,0
70938076@N00,1659,26,1249183956,1249183956,1,2,0
70938076@N00,1659,22,1249197079,1249197079,1,2,0
70938076@N00,1660,16,1249553014,1249553032,2,1,18
70938076@N00,1661,16,1250114820,1250114820,1,1,0
70938076@N00,1662,26,1250306869,1250307952,5,1,1083
70938076@N00,1663,19,1255600257,1255600289,3,1,32
70938076@N00,1664,16,1258513687,1258513687,1,1,0
70938076@N00,1665,28,1269092090,1269092090,1,1,0
70938076@N00,1666,19,1277470502,1277470502,1,1,0
70938076@N00,1667,2,1280670993,1280672512,2,1,1519
70938076@N00,1668,15,1282382883,1282382883,1,1,0
70938076@N00,1669,19,1282492842,1282492842,1,1,0
70938076@N00,1670,16,1283090151,1283090151,1,1,0
70938076@N00,1671,1,1299418293,1299418293,1,1,0
70938076@N00,1672,19,1300699754,1300699817,2,1,63
70938076@N00,1673,19,1306863001,1306863001,1,1,0
70938076@N00,1674,20,1307703688,1307703996,3,1,308
70938076@N00,1675,16,1307776749,1307778376,11,3,1627
70938076@N00,1675,20,1307774890,1307775204,2,3,314
70938076@N00,1675,2,1307781270,1307781270,1,3,0
70938076@N00,1676,16,1310099672,1310099672,1,1,0
70938076@N00,1677,20,1310805175,1310805723,5,1,548
70938076@N00,1678,21,1313468089,1313468320,3,2,231
70938076@N00,1678,2,1313468784,1313468784,1,2,0
70938076@N00,1679,25,1324011846,1324011846,1,1,0
70938076@N00,1680,19,1345281569,1345281922,4,1,353
70938076@N00,1681,13,1348376786,1348378731,6,1,1945
70938076@N00,1682,2,1353748594,1353748594,1,1,0
70938076@N00,1683,21,1366965871,1366966363,3,1,492
70938076@N00,1684,17,1383458730,1383458730,1,2,0
70938076@N00,1684,27,1383462152,1383462152,1,2,0
70938076@N00,1685,2,1392110435,1392110435,1,1,0
71088526@N00,1686,28,1340960122,1340960122,1,2,0
71088526@N00,1686,21,1340964283,1340964283,1,2,0
71088526@N00,1687,2,1341015815,1341018774,2,1,2959
71138480@N00,1688,2,1339127978,1339127978,1,1,0
71138480@N00,1689,26,1340097584,1340097783,2,2,199
71138480@N00,1689,17,1340084469,1340085287,4,2,818
71138480@N00,1690,16,1341374791,1341377487,5,1,2696
71428177@N00,1691,19,1222239566,1222239566,1,1,0
71428177@N00,1692,21,1260084251,1260084519,4,1,268
71428177@N00,1693,26,1299913342,1299913342,1,1,0
71428177@N00,1694,15,1365751994,1365751994,1,1,0
71428177@N00,1695,1,1372123293,1372132352,6,1,9059
71572112@N00,1696,20,1274131731,1274131731,1,2,0
71572112@N00,1696,28,1274130678,1274130678,1,2,0
71651012@N00,1697,16,1111212337,1111221747,3,1,9410
71748019@N00,1698,11,1209286276,1209286276,1,1,0
71998171@N00,1699,1,1188294362,1188294362,1,1,0
71998171@N00,1700,11,1188386402,1188386402,1,1,0
71998171@N00,1701,28,1188629308,1188629332,2,2,24
71998171@N00,1701,20,1188628394,1188628394,1,2,0
71998171@N00,1702,1,1188726158,1188726158,1,1,0
71998171@N00,1703,2,1188815856,1188815856,1,2,0
71998171@N00,1703,26,1188822028,1188822028,1,2,0
71998171@N00,1704,21,1188953562,1188953562,1,1,0
71998171@N00,1705,12,1189132774,1189132774,1,1,0
71998171@N00,1706,13,1239168829,1239169917,2,1,1088
7221539@N06,1707,1,1348114503,1348114737,2,1,234
72429059@N00,1708,11,1250747650,1250753051,6,2,5401
72429059@N00,1708,28,1250746900,1250746900,1,2,0
72436448@N00,1709,26,1244808061,1244808061,1,1,0
72579404@N00,1710,26,1219549969,1219562175,6,1,12206
72579404@N00,1711,2,1219648731,1219649122,2,3,391
72579404@N00,1711,16,1219649711,1219651687,4,3,1976
72579404@N00,1711,20,1219647807,1219647807,1,3,0
72746018@N00,1712,20,1249269211,1249269211,1,4,0
72746018@N00,1712,16,1249267047,1249267047,1,4,0
72746018@N00,1712,21,1249262661,1249265964,3,4,3303
72746018@N00,1712,11,1249270399,1249287928,6,4,17529
72746018@N00,1713,16,1249356104,1249361073,6,1,4969
72746018@N00,1714,28,1249390536,1249390536,1,2,0
72746018@N00,1714,16,1249397084,1249397084,1,2,0
72746018@N00,1715,20,1249439942,1249439942,1,3,0
72746018@N00,1715,10,1249467244,1249467244,1,3,0
72746018@N00,1715,11,1249434556,1249434556,1,3,0
72746018@N00,1716,10,1249545395,1249545395,1,2,0
72746018@N00,1716,9,1249542291,1249542318,2,2,27
73059421@N06,1717,1,1326976357,1326976357,1,1,0
73059421@N06,1718,1,1327022306,1327022306,1,1,0
73115625@N00,1719,26,1171097665,1171097665,1,1,0
73115625@N00,1720,28,1172468977,1172468977,1,1,0
73115625@N00,1721,20,1173771095,1173771095,1,1,0
73115625@N00,1722,12,1212663517,1212663517,1,1,0
73115625@N00,1723,20,1222497182,1222497182,1,1,0
73115625@N00,1724,21,1223714486,1223714486,1,2,0
73115625@N00,1724,16,1223714633,1223714633,1,2,0
73115625@N00,1725,19,1285210882,1285210882,1,1,0
73115625@N00,1726,20,1333525088,1333536034,23,1,10946
73115625@N00,1727,1,1348738779,1348739967,3,1,1188
73115625@N00,1728,19,1369901236,1369914138,70,1,12902
73115625@N00,1729,10,1394627387,1394627387,1,1,0
73422480@N00,1730,25,1197010288,1197010322,2,1,34
73422480@N00,1731,29,1197075272,1197075816,3,1,544
73429256@N00,1732,13,1305675617,1305675617,1,3,0
73429256@N00,1732,16,1305670719,1305670719,1,3,0
73429256@N00,1732,1,1305669542,1305669596,2,3,54
73502323@N00,1733,20,1240189211,1240196237,4,1,7026
73613701@N00,1734,12,1264228298,1264228338,4,1,40
74068217@N00,1735,21,1161317128,1161317919,2,1,791
74068217@N00,1736,13,1161466757,1161466961,3,1,204
74068217@N00,1737,15,1259593200,1259593200,1,2,0
74068217@N00,1737,21,1259593200,1259593200,1,2,0
74107232@N00,1738,10,1212813956,1212814206,5,1,250
7437393@N05,1739,15,1333111646,1333116289,2,1,4643
7437393@N05,1740,15,1333145396,1333145422,2,1,26
74614135@N00,1741,2,1144414796,1144414796,1,1,0
74614135@N00,1742,2,1145280967,1145283438,3,1,2471
74614135@N00,1743,22,1348198841,1348200438,5,1,1597
74614135@N00,1744,22,1348803303,1348803373,4,1,70
74614135@N00,1745,22,1349148310,1349148310,1,1,0
74614135@N00,1746,22,1349406420,1349406493,2,1,73
74614135@N00,1747,22,1349924307,1349924901,6,1,594
74614135@N00,1748,22,1350272378,1350272452,2,1,74
74614135@N00,1749,22,1350964417,1350964637,6,1,220
74733773@N00,1750,10,1076226276,1076226276,1,1,0
7473636@N06,1751,10,1260519405,1260519405,1,1,0
7473636@N06,1752,9,1261366673,1261366673,1,1,0
7473636@N06,1753,11,1261485283,1261485283,1,1,0
7473636@N06,1754,9,1262765123,1262765123,1,1,0
7473636@N06,1755,20,1263040604,1263040604,1,1,0
7473636@N06,1756,9,1263266522,1263266522,1,1,0
7473636@N06,1757,15,1263456719,1263456719,1,1,0
7473636@N06,1758,10,1263960315,1263960315,1,1,0
7473636@N06,1759,9,1267073727,1267073727,1,1,0
7473636@N06,1760,20,1267194510,1267196338,2,1,1828
7473636@N06,1761,15,1271771385,1271771385,1,2,0
7473636@N06,1761,10,1271771442,1271771442,1,2,0
7473636@N06,1762,9,1291612738,1291612738,1,1,0
7473636@N06,1763,10,1336620900,1336620900,1,1,0
7473636@N06,1764,10,1337656662,1337656662,1,1,0
7473636@N06,1765,10,1337917083,1337917083,1,1,0
7473636@N06,1766,10,1339120824,1339120824,1,1,0
7473636@N06,1767,9,1347595467,1347595467,1,1,0
7473636@N06,1768,10,1349661581,1349661581,1,1,0
7477459@N04,1769,20,1200470824,1200470986,6,2,162
7477459@N04,1769,2,1200468865,1200468865,1,2,0
7486487@N08,1770,2,1275206980,1275206980,1,2,0
7486487@N08,1770,16,1275208069,1275208789,4,2,720
74937968@N00,1771,1,1307359585,1307359585,1,1,0
74937968@N00,1772,1,1307418843,1307438405,2,1,19562
74937968@N00,1773,16,1307526916,1307526916,1,3,0
74937968@N00,1773,20,1307528326,1307528326,1,3,0
74937968@N00,1773,1,1307520190,1307526322,3,3,6132
75084208@N00,1774,12,1316940923,1316940923,1,2,0
75084208@N00,1774,28,1316916703,1316916703,1,2,0
7512717@N06,1775,28,1253340478,1253341836,12,2,1358
7512717@N06,1775,11,1253361192,1253361751,9,2,559
7512717@N06,1776,13,1340270885,1340270895,2,1,10
7512717@N06,1777,2,1359180196,1359180207,2,4,11
7512717@N06,1777,21,1359180356,1359180437,3,4,81
7512717@N06,1777,16,1359181118,1359181118,1,4,0
7512717@N06,1777,20,1359179698,1359209269,5,4,29571
7512717@N06,1778,20,1359718509,1359718622,3,5,113
7512717@N06,1778,21,1359703198,1359703284,4,5,86
7512717@N06,1778,2,1359718733,1359718733,1,5,0
7512717@N06,1778,16,1359703396,1359703600,5,5,204
7512717@N06,1778,12,1359704082,1359704485,13,5,403
7512717@N06,1779,11,1395054190,1395055125,4,3,935
7512717@N06,1779,16,1395043227,1395043227,1,3,0
7512717@N06,1779,1,1395042289,1395043242,4,3,953
75136617@N00,1780,11,1363952877,1363952877,1,1,0
75191422@N00,1781,1,1386468683,1386468683,1,1,0
75286866@N00,1782,19,1343979711,1343980383,2,1,672
75286866@N00,1783,16,1344476038,1344476038,1,2,0
75286866@N00,1783,11,1344474698,1344474698,1,2,0
75429951@N00,1784,1,1354104016,1354104016,1,1,0
75873727@N00,1785,19,1074954716,1074954716,1,1,0
75873727@N00,1786,16,1195276012,1195276012,1,1,0
75873727@N00,1787,2,1215737188,1215737188,1,1,0
75873727@N00,1788,1,1254977132,1254977132,1,1,0
75873727@N00,1789,18,1299067821,1299070175,3,1,2354
75873727@N00,1790,18,1299201452,1299201452,1,1,0
75873727@N00,1791,18,1313906887,1313912492,5,1,5605
75873727@N00,1792,19,1330079400,1330079400,1,1,0
75873727@N00,1793,18,1342064949,1342069930,13,1,4981
7587786@N05,1794,29,1095389135,1095389726,4,1,591
7587786@N05,1795,21,1215867810,1215873751,12,1,5941
7587786@N05,1796,1,1220065547,1220066216,8,3,669
7587786@N05,1796,21,1220066339,1220066948,7,3,609
7587786@N05,1796,2,1220067527,1220075562,8,3,8035
7587786@N05,1797,21,1225461901,1225466951,9,1,5050
7587786@N05,1798,19,1236679941,1236680715,5,2,774
7587786@N05,1798,26,1236682020,1236682811,5,2,791
7587786@N05,1799,21,1265213325,1265214170,7,1,845
7587786@N05,1800,13,1266739805,1266739805,1,1,0
7587786@N05,1801,28,1273908142,1273936139,51,1,27997
7587786@N05,1802,12,1280567632,1280591196,58,1,23564
7587786@N05,1803,22,1347146372,1347148038,4,1,1666
75951171@N02,1804,10,1343823406,1343823406,1,1,0
76312697@N00,1805,2,1334243887,1334243887,1,1,0
76696960@N00,1806,12,1363660871,1363660871,1,1,0
76802084@N00,1807,25,1191692978,1191692978,1,1,0
76802084@N00,1808,10,1193203791,1193203791,1,1,0
77047514@N00,1809,19,1196451070,1196451070,1,1,0
77047514@N00,1810,20,1214471747,1214485503,6,1,13756
77125925@N00,1811,25,1213422699,1213422699,1,1,0
77321230@N00,1812,19,1222220739,1222255101,23,1,34362
77321230@N00,1813,19,1222310298,1222328791,8,1,18493
77321230@N00,1814,15,1339207601,1339207623,3,1,22
77321230@N00,1815,10,1371713986,1371713986,1,1,0
77653713@N00,1816,2,1199956393,1199956393,1,1,0
77726415@N00,1817,16,1299835283,1299835287,2,1,4
77726415@N00,1818,15,1367572886,1367576388,2,1,3502
77726415@N00,1819,28,1367635623,1367635646,2,1,23
77914365@N02,1820,1,1323275953,1323275953,1,1,0
77914365@N02,1821,1,1328720300,1328722870,2,1,2570
77914365@N02,1822,1,1330533974,1330533974,1,1,0
77914365@N02,1823,1,1331739127,1331748180,2,1,9053
77914365@N02,1824,12,1332506570,1332506570,1,1,0
77914365@N02,1825,1,1334761475,1334768310,2,1,6835
77914365@N02,1826,1,1335976951,1335976951,1,1,0
77914365@N02,1827,1,1338391260,1338391260,1,1,0
77914365@N02,1828,1,1343225985,1343235226,6,1,9241
77914365@N02,1829,1,1345049538,1345050298,3,1,760
77914365@N02,1830,1,1345646834,1345653846,2,1,7012
77914365@N02,1831,1,1346247132,1346258321,2,1,11189
77914365@N02,1832,1,1346849589,1346864839,4,1,15250
77914365@N02,1833,16,1347033206,1347040432,2,1,7226
77914365@N02,1834,1,1348669670,1348680864,2,1,11194
77914365@N02,1835,1,1349277025,1349281574,2,1,4549
77914365@N02,1836,1,1349888826,1349888826,1,1,0
77914365@N02,1837,1,1350489974,1350490162,2,1,188
77914365@N02,1838,1,1351089203,1351095260,3,1,6057
77914365@N02,1839,1,1351701198,1351709274,4,1,8076
77914365@N02,1840,16,1352998717,1352998717,1,1,0
77914365@N02,1841,11,1363697362,1363697530,2,1,168
77914365@N02,1842,1,1365698942,1365698942,1,1,0
77914365@N02,1843,11,1367496450,1367496450,1,1,0
7797604@N05,1844,26,1276844674,1276844674,1,3,0
7797604@N05,1844,20,1276856384,1276856384,1,3,0
7797604@N05,1844,10,1276846449,1276846449,1,3,0
78115212@N00,1845,12,1280942626,1280942626,1,1,0
78251058@N00,1846,21,1333164886,1333164886,1,2,0
78251058@N00,1846,16,1333165198,1333165198,1,2,0
78506020@N00,1847,13,1242811114,1242811114,1,1,0
78506020@N00,1848,13,1242868385,1242868505,4,1,120
7856302@N02,1849,12,1335606712,1335606712,1,1,0
7868489@N05,1850,6,1189326660,1189326660,1,1,0
7868489@N05,1851,2,1189403501,1189416448,15,3,12947
7868489@N05,1851,28,1189416591,1189416591,1,3,0
7868489@N05,1851,13,1189399609,1189402115,13,3,2506
7883724@N05,1852,21,1364637498,1364637498,1,3,0
7883724@N05,1852,2,1364634633,1364634633,1,3,0
7883724@N05,1852,13,1364641671,1364646678,7,3,5007
7885919@N07,1853,13,1216029239,1216031290,6,2,2051
7885919@N07,1853,2,1216027821,1216027821,1,2,0
78953420@N00,1854,13,1343458619,1343458619,1,1,0
78976320@N00,1855,26,1313220640,1313224602,14,1,3962
78976320@N00,1856,2,1313295757,1313295849,3,2,92
78976320@N00,1856,13,1313297445,1313298376,2,2,931
78977545@N00,1857,11,1242785619,1242785619,1,1,0
78981276@N03,1858,27,1341693646,1341693993,6,1,347
79235216@N00,1859,10,1190522071,1190522071,1,2,0
79235216@N00,1859,9,1190521572,1190521572,2,2,0
79235216@N00,1860,25,1237525787,1237525813,2,2,26
79235216@N00,1860,26,1237526294,1237526623,3,2,329
79295762@N00,1861,13,1287629580,1287629580,1,1,0
79483207@N00,1862,11,1345189383,1345189642,3,2,259
79483207@N00,1862,12,1345189303,1345189303,1,2,0
79578508@N08,1863,9,1359370999,1359370999,1,1,0
79583295@N05,1864,2,1335967969,1335967969,1,1,0
79583295@N05,1865,2,1339056697,1339056697,1,1,0
79583295@N05,1866,26,1339124814,1339125692,11,1,878
7984099@N05,1867,10,1252470453,1252470453,1,1,0
7990203@N03,1868,10,1242255810,1242255810,1,1,0
80017454@N00,1869,13,1274590648,1274590648,1,1,0
80018584@N06,1870,2,1350176268,1350177262,3,2,994
80018584@N06,1870,21,1350179087,1350179317,2,2,230
80424201@N00,1871,16,1183442700,1183446455,3,1,3755
8060457@N02,1872,16,1256528033,1256528033,1,1,0
80649505@N08,1873,13,1373002215,1373004340,2,1,2125
8067411@N07,1874,19,1229414203,1229416392,2,1,2189
8067411@N07,1875,19,1229468552,1229468662,2,1,110
8067411@N07,1876,19,1264635943,1264635943,1,1,0
8067411@N07,1877,19,1264666265,1264666265,1,1,0
8072746@N06,1878,25,1210137661,1210137661,1,1,0
8072746@N06,1879,26,1210308384,1210308384,1,1,0
80975088@N00,1880,1,1089039600,1089039604,5,1,4
81023277@N00,1881,1,1211729993,1211736723,4,1,6730
81023277@N00,1882,10,1212499954,1212499954,1,1,0
81023277@N00,1883,26,1213512337,1213513373,8,1,1036
81023277@N00,1884,22,1217134070,1217137294,9,1,3224
81023277@N00,1885,1,1224848813,1224849865,6,1,1052
81023277@N00,1886,10,1225347694,1225347694,1,1,0
81023277@N00,1887,26,1244959410,1244962267,10,1,2857
81023277@N00,1888,2,1259998786,1259998786,1,1,0
81023277@N00,1889,21,1280543523,1280543865,8,2,342
81023277@N00,1889,22,1280548281,1280557281,12,2,9000
81023277@N00,1890,1,1280715081,1280718897,2,1,3816
81213601@N04,1891,18,1381489707,1381489707,1,1,0
81867054@N00,1892,20,1232179941,1232179941,1,1,0
82103247@N00,1893,2,1172284889,1172284889,1,1,0
82103247@N00,1894,2,1217722816,1217722816,1,1,0
82103247@N00,1895,10,1282797633,1282797633,1,2,0
82103247@N00,1895,16,1282785909,1282785909,1,2,0
82103247@N00,1896,2,1353054520,1353054520,1,3,0
82103247@N00,1896,16,1353052229,1353054105,3,3,1876
82103247@N00,1896,21,1353052048,1353052441,4,3,393
82103247@N00,1897,20,1358579134,1358579134,1,3,0
82103247@N00,1897,21,1358569516,1358571509,7,3,1993
82103247@N00,1897,16,1358564763,1358574486,8,3,9723
82103247@N00,1898,20,1359791693,1359791693,1,3,0
82103247@N00,1898,21,1359781504,1359784202,8,3,2698
82103247@N00,1898,16,1359775228,1359775228,1,3,0
82103247@N00,1899,20,1371274593,1371274595,2,2,2
82103247@N00,1899,21,1371268618,1371269538,7,2,920
82103247@N00,1900,21,1396665905,1396665905,1,4,0
82103247@N00,1900,1,1396664213,1396664213,1,4,0
82103247@N00,1900,16,1396663864,1396663864,1,4,0
82103247@N00,1900,2,1396662931,1396669703,9,4,6772
82474542@N00,1901,22,1234095877,1234095976,2,1,99
82474542@N00,1902,13,1234137986,1234137986,1,1,0
82474542@N00,1903,12,1252574281,1252574281,1,1,0
82482569@N00,1904,26,1205227649,1205227649,1,1,0
82482569@N00,1905,26,1205315436,1205330843,6,2,15407
82482569@N00,1905,29,1205315482,1205315482,1,2,0
82508858@N00,1906,11,1113847488,1113847488,1,1,0
82508858@N00,1907,11,1114122621,1114122621,1,1,0
82619366@N00,1908,19,1163160949,1163165768,4,1,4819
82619366@N00,1909,12,1187948889,1187949322,2,3,433
82619366@N00,1909,10,1187938687,1187940843,5,3,2156
82619366@N00,1909,2,1187976576,1187976576,1,3,0
82619366@N00,1910,15,1234150368,1234150368,1,4,0
82619366@N00,1910,9,1234149224,1234150498,5,4,1274
82619366@N00,1910,26,1234149618,1234149618,1,4,0
82619366@N00,1910,10,1234148955,1234150398,3,4,1443
82684581@N00,1911,21,1266380356,1266380356,1,1,0
82684581@N00,1912,21,1266468174,1266468174,1,1,0
82684581@N00,1913,21,1266555229,1266555229,1,1,0
82684581@N00,1914,21,1266814510,1266814510,1,1,0
82684581@N00,1915,20,1266986734,1266986734,1,2,0
82684581@N00,1915,21,1266985809,1266985809,1,2,0
82684581@N00,1916,16,1267068914,1267068914,1,1,0
82684581@N00,1917,21,1267159622,1267159622,1,1,0
82684581@N00,1918,21,1267419577,1267419577,1,1,0
82684581@N00,1919,21,1267502516,1267502591,2,2,75
82684581@N00,1919,2,1267502677,1267502677,1,2,0
82684581@N00,1920,21,1267589046,1267589140,2,1,94
82684581@N00,1921,21,1267764494,1267764494,1,1,0
82684581@N00,1922,21,1268213175,1268213175,1,1,0
82684581@N00,1923,21,1282092773,1282092773,1,1,0
82684581@N00,1924,21,1282868780,1282868780,1,1,0
82684581@N00,1925,21,1288067272,1288067272,1,1,0
82684581@N00,1926,21,1289370474,1289370474,1,1,0
82684581@N00,1927,21,1292552505,1292552727,2,1,222
82684581@N00,1928,21,1293077551,1293077551,1,1,0
82684581@N00,1929,2,1293431184,1293431184,1,1,0
82684581@N00,1930,21,1295236806,1295236806,1,1,0
82684581@N00,1931,21,1299733934,1299733934,1,1,0
82684581@N00,1932,26,1302068244,1302069317,2,1,1073
82684581@N00,1933,2,1305688821,1305688821,1,1,0
82684581@N00,1934,22,1305863489,1305864910,2,1,1421
82684581@N00,1935,21,1308799910,1308799910,1,1,0
82684581@N00,1936,21,1325667852,1325667852,1,1,0
82684581@N00,1937,21,1327367000,1327367000,1,1,0
82684581@N00,1938,21,1346731818,1346731818,1,1,0
82684581@N00,1939,26,1347084334,1347092969,4,1,8635
82684581@N00,1940,21,1348827789,1348827830,2,1,41
82684581@N00,1941,21,1355882947,1355883270,2,1,323
82684581@N00,1942,21,1362646680,1362646680,1,1,0
82684581@N00,1943,28,1370059668,1370059668,1,1,0
82684581@N00,1944,21,1370315727,1370315727,1,1,0
82684581@N00,1945,21,1374036110,1374036110,1,1,0
82684581@N00,1946,21,1374204132,1374205218,3,1,1086
82684581@N00,1947,21,1379650357,1379650357,1,1,0
82684581@N00,1948,21,1387512186,1387513910,9,1,1724
82684581@N00,1949,26,1392004697,1392004697,1,1,0
8286908@N02,1950,10,1278986544,1278987924,8,3,1380
8286908@N02,1950,13,1278986665,1278992339,11,3,5674
8286908@N02,1950,2,1278983001,1278983001,1,3,0
82969084@N06,1951,16,1344747825,1344753132,15,1,5307
83129246@N00,1952,21,1180760624,1180760624,1,2,0
83129246@N00,1952,16,1180761829,1180761829,1,2,0
83129246@N00,1953,16,1187979957,1188000304,39,1,20347
83432431@N00,1954,1,1336796117,1336797187,5,1,1070
83432431@N00,1955,21,1366719872,1366719939,2,1,67
83542829@N00,1956,1,1339569303,1339569303,1,2,0
83542829@N00,1956,21,1339561637,1339561637,1,2,0
83827067@N00,1957,1,1123115698,1123117748,4,2,2050
83827067@N00,1957,19,1123136713,1123143436,14,2,6723
83827067@N00,1958,19,1123229040,1123243682,19,2,14642
83827067@N00,1958,29,1123250923,1123250976,2,2,53
83827067@N00,1959,21,1123304754,1123304754,1,2,0
83827067@N00,1959,29,1123331449,1123332624,2,2,1175
83827067@N00,1960,19,1123413919,1123417958,9,1,4039
83827067@N00,1961,19,1123481078,1123481078,1,1,0
84035351@N00,1962,13,1146245171,1146248026,9,1,2855
84035351@N00,1963,2,1146421729,1146421729,1,1,0
84035351@N00,1964,13,1147564239,1147564239,1,1,0
84035351@N00,1965,2,1207982260,1207982407,2,1,147
84195101@N00,1966,16,1380810309,1380810309,1,1,0
84272941@N00,1967,13,1302238479,1302245150,7,1,6671
84272941@N00,1968,25,1303712192,1303712791,2,2,599
84272941@N00,1968,15,1303706815,1303708051,6,2,1236
84272941@N00,1969,21,1305348882,1305350952,3,1,2070
84272941@N00,1970,11,1310874536,1310876309,3,1,1773
84272941@N00,1971,2,1311396113,1311396113,1,1,0
84272941@N00,1972,25,1312433062,1312433062,1,1,0
84272941@N00,1973,2,1313659372,1313660159,5,2,787
84272941@N00,1973,21,1313660969,1313662386,5,2,1417
84272941@N00,1974,2,1322396082,1322396082,1,1,0
84272941@N00,1975,21,1344226478,1344227542,2,3,1064
84272941@N00,1975,16,1344226286,1344226286,1,3,0
84272941@N00,1975,2,1344222099,1344222395,2,3,296
84272941@N00,1976,12,1350729066,1350736087,6,1,7021
84272941@N00,1977,20,1356758529,1356758529,1,1,0
84272941@N00,1978,21,1357990419,1357992296,3,1,1877
84272941@N00,1979,2,1361683983,1361683983,1,1,0
84272941@N00,1980,13,1364095516,1364095516,1,1,0
84338502@N00,1981,29,1350655316,1350655316,1,2,0
84338502@N00,1981,12,1350653787,1350653787,1,2,0
84940312@N02,1982,8,1349208920,1349208920,1,1,0
8503026@N04,1983,1,1281515873,1281515873,1,1,0
8503026@N04,1984,1,1281592293,1281592293,1,5,0
8503026@N04,1984,2,1281595541,1281595753,2,5,212
8503026@N04,1984,26,1281585987,1281586050,2,5,63
8503026@N04,1984,10,1281588351,1281588351,1,5,0
8503026@N04,1984,9,1281587305,1281587305,1,5,0
8520591@N03,1985,13,1248417216,1248420312,4,2,3096
8520591@N03,1985,21,1248408477,1248408477,1,2,0
8520591@N03,1986,11,1248511425,1248511425,1,1,0
85217508@N00,1987,21,1251000829,1251028042,2,6,27213
85217508@N00,1987,13,1251025685,1251026430,4,6,745
85217508@N00,1987,2,1251027815,1251028492,2,6,677
85217508@N00,1987,16,1251001076,1251002872,3,6,1796
85217508@N00,1987,27,1251010729,1251013545,4,6,2816
85217508@N00,1987,11,1251021530,1251021530,1,6,0
85218131@N00,1988,2,1220347466,1220347466,1,1,0
85318305@N00,1989,1,1375457610,1375457610,1,1,0
85353067@N00,1990,19,1221812863,1221812863,1,1,0
85397137@N00,1991,1,1303886154,1303886154,1,4,0
85397137@N00,1991,29,1303876966,1303876966,1,4,0
85397137@N00,1991,20,1303871901,1303871901,1,4,0
85397137@N00,1991,16,1303870971,1303871392,2,4,421
85397137@N00,1992,1,1306136106,1306136302,4,1,196
85397137@N00,1993,16,1336533495,1336533528,2,2,33
85397137@N00,1993,1,1336541390,1336541390,1,2,0
85397137@N00,1994,14,1344927833,1344927857,2,1,24
85397137@N00,1995,19,1347785734,1347786204,3,1,470
85456381@N00,1996,25,1240134087,1240134264,3,1,177
85699190@N00,1997,11,1165297544,1165297668,8,1,124
85699190@N00,1998,11,1169635292,1169635292,6,1,0
85714479@N00,1999,16,1187996810,1188002868,39,1,6058
85714479@N00,2000,10,1348277457,1348277457,1,1,0
85714479@N00,2001,14,1349747154,1349747154,1,1,0
86052519@N00,2002,15,1385359181,1385359181,1,1,0
86052519@N00,2003,10,1385424998,1385425112,2,1,114
86052519@N00,2004,15,1385554969,1385561525,4,1,6556
86052519@N00,2005,13,1385611410,1385612452,4,1,1042
86227048@N00,2006,16,1287201223,1287201223,1,2,0
86227048@N00,2006,2,1287202525,1287202525,1,2,0
86424983@N00,2007,1,1286621847,1286629328,5,1,7481
86533211@N00,2008,16,1219662545,1219662545,1,1,0
86848774@N00,2009,21,1329209092,1329209092,1,1,0
86848774@N00,2010,21,1329382115,1329382115,1,1,0
86848774@N00,2011,11,1331446778,1331446778,1,1,0
86848774@N00,2012,21,1333446114,1333446114,1,1,0
86848774@N00,2013,11,1333893633,1333893633,1,1,0
86848774@N00,2014,11,1340421896,1340421896,1,1,0
86848774@N00,2015,22,1346926547,1346926547,1,1,0
86896868@N00,2016,13,1341340064,1341355807,5,1,15743
87087035@N00,2017,2,1112003196,1112008801,2,1,5605
87296837@N00,2018,16,1382017404,1382017404,1,1,0
87296837@N00,2019,2,1382073350,1382073417,2,1,67
87363185@N00,2020,12,1217758273,1217758290,2,1,17
87363185@N00,2021,12,1244354070,1244354281,2,1,211
87463936@N00,2022,5,1158914333,1158914333,1,1,0
88010593@N04,2023,13,1340514701,1340514701,1,1,0
88109591@N00,2024,18,1225881770,1225881770,1,1,0
88254201@N00,2025,26,1397270296,1397279618,31,2,9322
88254201@N00,2025,10,1397267374,1397269770,24,2,2396
88282231@N00,2026,11,1163828827,1163849474,31,1,20647
8831655@N07,2027,19,1216444218,1216447507,7,1,3289
88461255@N00,2028,2,1181304993,1181304993,1,1,0
88924654@N00,2029,13,1302417311,1302417725,2,1,414
8897541@N02,2030,21,1373525016,1373525016,1,1,0
89182227@N00,2031,2,1253148807,1253148807,1,1,0
89182227@N00,2032,18,1254394424,1254395042,6,1,618
89182227@N00,2033,2,1260322450,1260322450,1,1,0
89182227@N00,2034,20,1263442500,1263442500,1,1,0
89182227@N00,2035,24,1264829095,1264831145,3,1,2050
89182227@N00,2036,20,1267869964,1267869964,1,1,0
89182227@N00,2037,26,1268971932,1268971932,1,2,0
89182227@N00,2037,25,1268971335,1268973303,3,2,1968
89182227@N00,2038,25,1269326943,1269326943,1,1,0
89182227@N00,2039,21,1269503263,1269503263,1,1,0
89182227@N00,2040,24,1282389334,1282389334,1,1,0
89182227@N00,2041,6,1287574218,1287576329,5,1,2111
89182227@N00,2042,11,1316996222,1316996224,2,1,2
89182227@N00,2043,15,1329997402,1330002214,47,1,4812
89182227@N00,2044,1,1343792954,1343792954,1,2,0
89182227@N00,2044,16,1343795780,1343795780,2,2,0
89182227@N00,2045,1,1376054433,1376056435,24,1,2002
89182227@N00,2046,1,1378980592,1378990396,55,1,9804
89182227@N00,2047,9,1395462217,1395462226,2,3,9
89182227@N00,2047,10,1395460281,1395461813,6,3,1532
89182227@N00,2047,15,1395458581,1395463779,14,3,5198
89611854@N00,2048,2,1330495645,1330495645,1,1,0
89611854@N00,2049,11,1346324956,1346328645,3,1,3689
89611854@N00,2050,16,1398065298,1398065298,1,1,0
8970099@N04,2051,2,1372129132,1372129132,1,2,0
8970099@N04,2051,1,1372128503,1372128513,2,2,10
8970099@N04,2052,2,1372316701,1372316701,1,1,0
89782291@N00,2053,29,1167824732,1167824732,1,1,0
89782291@N00,2054,4,1300511663,1300511663,1,1,0
89782291@N00,2055,2,1323071290,1323071290,1,1,0
89782291@N00,2056,19,1326527953,1326527953,1,1,0
90001203@N00,2057,1,1239269239,1239285495,6,1,16256
90001203@N00,2058,2,1266583345,1266583345,1,1,0
90001203@N00,2059,22,1320533654,1320533654,1,1,0
90001203@N00,2060,19,1342772825,1342772934,5,1,109
90001203@N00,2061,2,1343459687,1343459721,2,1,34
90131400@N00,2062,16,1346654199,1346654907,7,2,708
90131400@N00,2062,21,1346647543,1346647543,1,2,0
90151774@N00,2063,1,1206112520,1206112520,1,1,0
90151774@N00,2064,13,1206266212,1206266212,1,1,0
90338469@N00,2065,11,1312379999,1312380000,2,1,1
90338469@N00,2066,11,1312439489,1312445448,4,1,5959
90338469@N00,2067,11,1312523119,1312523119,1,1,0
90664717@N00,2068,28,1165899111,1165899111,1,2,0
90664717@N00,2068,16,1165896580,1165896611,2,2,31
90847750@N00,2069,20,1342586918,1342592996,3,1,6078
90847750@N00,2070,26,1342770768,1342770768,1,1,0
90847750@N00,2071,13,1342847203,1342847203,1,2,0
90847750@N00,2071,20,1342844564,1342862686,3,2,18122
9087290@N02,2072,15,1273142733,1273148878,10,1,6145
9087290@N02,2073,20,1281696715,1281697114,2,1,399
9087290@N02,2074,16,1303962251,1303962251,1,1,0
9087290@N02,2075,16,1309522358,1309533390,7,1,11032
9087290@N02,2076,12,1327158809,1327158809,1,1,0
9087290@N02,2077,16,1382519717,1382519717,1,1,0
91179257@N02,2078,1,1396444986,1396444986,1,1,0
91481651@N00,2079,17,1397262901,1397262901,1,1,0
91685781@N00,2080,16,1216431856,1216431883,2,3,27
91685781@N00,2080,2,1216433173,1216433225,2,3,52
91685781@N00,2080,21,1216432884,1216432884,1,3,0
91712888@N00,2081,28,1376535872,1376535872,1,1,0
91779914@N00,2082,22,1186793832,1186793832,1,1,0
91779914@N00,2083,22,1281745204,1281745527,3,1,323
91796142@N00,2084,21,1127966746,1127966746,1,1,0
91796142@N00,2085,10,1131776803,1131776803,1,1,0
92129713@N00,2086,16,1238478741,1238478741,1,1,0
92129713@N00,2087,16,1238664354,1238664354,1,1,0
92129713@N00,2088,2,1239289830,1239289830,1,1,0
92129713@N00,2089,16,1240468762,1240468762,1,1,0
92129713@N00,2090,16,1240550093,1240550093,1,1,0
92129713@N00,2091,28,1240837464,1240837464,1,1,0
92129713@N00,2092,16,1241428017,1241428017,1,1,0
92129713@N00,2093,16,1241585582,1241585582,1,1,0
92129713@N00,2094,12,1241797356,1241797356,1,1,0
92129713@N00,2095,2,1242204096,1242204096,1,1,0
92129713@N00,2096,12,1242625661,1242625661,1,1,0
92129713@N00,2097,15,1243579385,1243579385,1,1,0
92129713@N00,2098,6,1243939023,1243939023,1,1,0
92129713@N00,2099,2,1244019704,1244019704,1,1,0
92129713@N00,2100,15,1305190914,1305190914,1,1,0
92367195@N00,2101,27,1205907021,1205907029,2,1,8
92367195@N00,2102,27,1205986765,1205990730,9,1,3965
92367195@N00,2103,10,1221210047,1221210047,1,2,0
92367195@N00,2103,26,1221209026,1221209026,1,2,0
92367195@N00,2104,9,1221370961,1221370961,1,1,0
92367195@N00,2105,26,1228719723,1228722680,14,3,2957
92367195@N00,2105,17,1228710801,1228710801,1,3,0
92367195@N00,2105,27,1228705080,1228710750,2,3,5670
92367195@N00,2106,15,1231142710,1231142710,1,1,0
92367195@N00,2107,6,1247746997,1247747011,4,1,14
92367195@N00,2108,11,1255242086,1255242086,1,1,0
92367195@N00,2109,15,1255737224,1255737374,2,1,150
92367195@N00,2110,25,1263007713,1263007713,1,1,0
92367195@N00,2111,25,1266029767,1266029767,1,1,0
92367195@N00,2112,10,1271399306,1271400035,2,1,729
92367195@N00,2113,25,1273117533,1273117533,1,1,0
92367195@N00,2114,21,1276562476,1276562476,1,1,0
92367195@N00,2115,15,1279373058,1279373058,1,1,0
92367195@N00,2116,21,1279462267,1279462267,1,1,0
92367195@N00,2117,21,1294802733,1294809420,4,1,6687
92367195@N00,2118,16,1297605798,1297606187,3,1,389
92367195@N00,2119,21,1311080993,1311080993,1,1,0
92367195@N00,2120,16,1385177921,1385177921,1,1,0
92431035@N00,2121,1,1275207019,1275208011,5,1,992
92431035@N00,2122,1,1275292995,1275293325,2,1,330
92514202@N00,2123,1,1245505997,1245505997,1,1,0
92514202@N00,2124,13,1326718440,1326718510,2,1,70
92723847@N00,2125,21,893948400,893948400,1,1,0
92723847@N00,2126,11,915116400,915116400,1,1,0
92723847@N00,2127,11,949330800,949330800,1,1,0
92723847@N00,2128,11,1107242865,1107242865,1,1,0
92723847@N00,2129,11,1109086915,1109086915,1,1,0
92723847@N00,2130,11,1122111562,1122111562,1,1,0
92723847@N00,2131,16,1152264081,1152266301,5,1,2220
92723847@N00,2132,21,1156763427,1156764526,5,1,1099
92723847@N00,2133,15,1181453678,1181453678,1,1,0
92723847@N00,2134,26,1185261324,1185261371,5,1,47
92723847@N00,2135,1,1193139981,1193141723,6,1,1742
92723847@N00,2136,28,1193305545,1193313266,11,1,7721
92723847@N00,2137,1,1208949672,1208950163,5,2,491
92723847@N00,2137,16,1208948865,1208949519,4,2,654
92723847@N00,2138,16,1242737994,1242737994,1,1,0
92723847@N00,2139,7,1285295935,1285295935,1,1,0
92782066@N00,2140,11,1251879020,1251879020,1,1,0
92854825@N00,2141,2,1334376360,1334376360,1,1,0
9286726@N03,2142,2,1179275603,1179297167,17,4,21564
9286726@N03,2142,21,1179276454,1179276454,1,4,0
9286726@N03,2142,13,1179278787,1179284042,40,4,5255
9286726@N03,2142,1,1179277218,1179279874,12,4,2656
93472925@N00,2143,11,1290510776,1290517612,17,1,6836
93781857@N00,2144,10,1355194317,1355194317,1,1,0
94299816@N00,2145,26,1384406086,1384406086,1,1,0
94393544@N00,2146,29,1197032383,1197044133,55,1,11750
94404470@N00,2147,19,1267414170,1267414424,6,1,254
94404470@N00,2148,20,1284982735,1284982735,1,1,0
9458870@N07,2149,11,1340001343,1340005094,3,1,3751
9458870@N07,2150,11,1340170233,1340170233,1,1,0
9458870@N07,2151,11,1340694708,1340699070,3,1,4362
9458870@N07,2152,11,1340778609,1340778609,1,1,0
94735786@N00,2153,2,1363768758,1363768758,1,1,0
9511818@N03,2154,21,1368764474,1368764474,1,1,0
9511818@N03,2155,21,1369375375,1369377131,2,3,1756
9511818@N03,2155,1,1369379934,1369379934,1,3,0
9511818@N03,2155,16,1369374757,1369377249,2,3,2492
9511818@N03,2156,10,1371966045,1371970833,10,2,4788
9511818@N03,2156,15,1371962284,1371973336,14,2,11052
95285464@N00,2157,2,938358000,938358002,3,1,2
9539613@N03,2158,13,1368240783,1368240783,1,1,0
95457978@N00,2159,11,1104505200,1104505200,1,1,0
95808812@N00,2160,2,1382695242,1382695242,1,2,0
95808812@N00,2160,20,1382694964,1382694964,1,2,0
9588476@N02,2161,2,1392204173,1392204173,1,1,0
96424614@N00,2162,2,1244795366,1244795366,1,1,0
96485480@N00,2163,21,1201008794,1201008794,1,1,0
9656812@N03,2164,27,1343183022,1343202849,7,1,19827
96628098@N00,2165,13,1376616653,1376616653,1,1,0
96684313@N00,2166,26,1206358605,1206365115,25,1,6510
96684313@N00,2167,16,1214455225,1214455525,5,2,300
96684313@N00,2167,20,1214469085,1214469205,2,2,120
96684313@N00,2168,26,1216605795,1216611555,10,1,5760
96684313@N00,2169,26,1216974119,1216974137,2,1,18
96684313@N00,2170,26,1221218834,1221218834,1,1,0
96684313@N00,2171,20,1229491457,1229492546,3,1,1089
96684313@N00,2172,15,1307957782,1307957782,1,1,0
96684313@N00,2173,9,1309226796,1309243038,2,1,16242
96684313@N00,2174,28,1323417001,1323417793,2,1,792
96721948@N00,2175,1,1195188668,1195188668,1,2,0
96721948@N00,2175,16,1195190549,1195190549,1,2,0
96854970@N00,2176,7,1383537712,1383538061,10,1,349
96854970@N00,2177,7,1383609344,1383609344,1,1,0
96854970@N00,2178,7,1383701909,1383703420,11,1,1511
97206958@N00,2179,2,1358735523,1358735523,1,1,0
97206958@N00,2180,2,1362387517,1362387517,1,1,0
97576841@N04,2181,15,1385079316,1385079316,1,1,0
97576841@N04,2182,20,1385770034,1385770034,1,1,0
97595808@N00,2183,19,1159588451,1159588491,2,1,40
97595808@N00,2184,21,1237612382,1237622154,5,2,9772
97595808@N00,2184,2,1237596083,1237622352,9,2,26269
97595808@N00,2185,15,1273110785,1273110785,1,2,0
97595808@N00,2185,10,1273129436,1273129436,1,2,0
97595808@N00,2186,10,1282707097,1282709244,3,2,2147
97595808@N00,2186,9,1282709925,1282712376,4,2,2451
97595808@N00,2187,26,1298175607,1298176563,2,1,956
97595808@N00,2188,2,1316243211,1316243211,1,1,0
97768382@N00,2189,7,1188205922,1188206250,4,1,328
9788232@N03,2190,21,1316767868,1316767868,1,1,0
9788232@N03,2191,21,1316819827,1316819827,1,1,0
97891310@N00,2192,19,1316757535,1316757535,1,1,0
98068999@N05,2193,16,1375939837,1375939837,1,1,0
98137912@N00,2194,29,1208247302,1208247302,1,1,0
98137912@N00,2195,19,1215487193,1215491006,10,1,3813
98137912@N00,2196,6,1256704099,1256704221,5,1,122
98137912@N00,2197,20,1309428368,1309428368,1,1,0
98137912@N00,2198,28,1311932573,1311932573,1,1,0
98137912@N00,2199,20,1378897057,1378900673,7,1,3616
9828412@N05,2200,11,1339066637,1339073693,12,1,7056
9828412@N05,2201,28,1339169495,1339169495,1,2,0
9828412@N05,2201,11,1339146597,1339147507,2,2,910
9828412@N05,2202,16,1339226185,1339227448,7,1,1263
9828412@N05,2203,26,1339497186,1339498233,2,3,1047
9828412@N05,2203,11,1339498962,1339498962,1,3,0
9828412@N05,2203,28,1339499494,1339499494,1,3,0
9828412@N05,2204,11,1339648645,1339652617,8,1,3972
9828412@N05,2205,10,1339821409,1339821798,3,2,389
9828412@N05,2205,9,1339819497,1339822164,7,2,2667
9828412@N05,2206,17,1374640744,1374640744,1,1,0
98523633@N00,2207,13,1202016880,1202018129,8,1,1249
98523633@N00,2208,16,1203227017,1203230248,10,1,3231
98523633@N00,2209,13,1293083134,1293083624,2,1,490
98549503@N00,2210,10,1291014287,1291014287,1,1,0
98549503@N00,2211,10,1317286740,1317286740,1,1,0
9875906@N02,2212,21,1385994496,1385994496,1,1,0
98833136@N00,2213,21,1227430164,1227430164,1,3,0
98833136@N00,2213,13,1227426989,1227428520,4,3,1531
98833136@N00,2213,2,1227429729,1227429729,1,3,0
98833136@N00,2214,2,1284689260,1284689260,1,2,0
98833136@N00,2214,16,1284690710,1284690710,1,2,0
98833136@N00,2215,7,1287831736,1287831736,1,1,0
98833136@N00,2216,18,1287895579,1287895579,1,1,0
98833136@N00,2217,11,1289402454,1289402856,2,1,402
98833136@N00,2218,21,1339832525,1339832542,2,2,17
98833136@N00,2218,20,1339845239,1339845239,1,2,0
98833136@N00,2219,18,1352818409,1352818409,1,1,0
99043785@N00,2220,11,1197604301,1197604301,1,1,0
99043785@N00,2221,11,1200905738,1200905738,1,1,0
99043785@N00,2222,11,1202092091,1202095633,3,1,3542
99166986@N00,2223,1,1151232709,1151232709,1,1,0
99166986@N00,2224,2,1153806167,1153806434,2,1,267
99408200@N05,2225,13,1384933110,1384933110,1,1,0
99646216@N00,2226,13,1253776035,1253776035,1,2,0
99646216@N00,2226,14,1253765042,1253765042,1,2,0
